content	label
سبحان الله بحمده عدد خلقه رضى نفسه زنه عرشه مداد كلماته	Positive
سبحان الله مالك السموات الارض	Positive
قصه جميله جدا تعكس معنى الايمان التمسك بالعقيده الصحيحه حسن تعاليمها	Positive
سنبقى نذكر دوله الشهيد وصفي التل الذي كان رئيسا للوزراء حبيبا للفقراء	Negative
اول واحد ذكرنى بصاحب اسمه قرده	Negative
الحمد لله الذي رزقني بالاسلام	Positive
نحن في زمن يهان فيه المرء ويكرم فيه الكلب	Negative
ثبتك الله يا استاذي ونصرك	Positive
مع مين بتحكي بتول انشالله مع حالك	Negative
اللهم ارزقنا الصحبه الصالحه	Positive
دعوه المؤمن لاخيه بظهر الغيب اسرع من البرق	Positive
بوركت جهودك و سلمت اناملك	Positive
شو هالافكار الجهنميه	Negative
لا تفهمي غلط حبيبتي	Negative
الدين ليس بالمظاهر الدين المعامله حياء وادب واحترام وانتقاء للالفاض الطيبه	Positive
احب الله تعالى و رسوله الكريم	Positive
الله لا يشبعكو يا ظلمه انشاء الله كلو بتلقو بالاخره يا ظلمه خافوالله طبعا اذا بتعرفوالله	Negative
اهلا بك في دين الحق والسلام	Positive
عندك حق انت امل جميل مشرق	Positive
روح موت وانتحر	Negative
هذا اللي بالنص من لجنه الحكم مفكر نفسو وديع الصافي هو شقفه علاك	Negative
خت قرار كتير وبرجع تاني بحاول اتغير ومش عرفه	Positive
مطلوب نصيحه منك لكي نستحضر الخشوع	Positive
امين يا رب انت شاب زي الفل ما شاء الله عليك	Positive
عاهاتك يا وطنعاهاتك يا وطن	Negative
اللهم كن مع اخواننا في سوريا	Positive
الذي طبعه رائع ما يمكن ان يتغير راح يبقه رائع	Positive
حلمي ان اكون مثل سوشي	Positive
طموح الانسان يدفه لتحقيق اهدافه يا رت شببنا ما يقولن فات الوقت الله يوفق من يشاء	Positive
يا مصلح القلوب اصلح احوالنا يا مسهل يا رب	Positive
كل واحد حرامي ما بهمو مصلحه المسكين المواطن الي بشتغل 14ساعه 6دنانير	Negative
نيله تنيلكم من وين جايبين هالحثانه	Negative
ن مقابله جلاله الملك عبدالله مع قناه سي بي اس الاميركيه . يؤرقني تامين فرص الحياه الكريمه لشباب الاردن و لن نسمح للارهاب بالعبث في الاردن	Negative
كلمات رائعه حلوه لا احلى ان يكونو في النهايه رائعون	Positive
قهروني حرام	Negative
والشرهه على الاغبياء اللي معطينك لايك	Negative
بدي اروح عمره الله ييسر	Positive
مش عارف ليه بيتحوله هما الى دواره عليك وكان نفسهم تكون معاهم فى الاول	Positive
صباح الورد الجوري الحمر والخمري	Positive
الله يهدي النفوس ربي ابعث لنا في هذا اليوم فرح يغير ايامنا وينعش قلوبنا من جديد	Positive
اسال الله في علاه ان يحفظكم بما يحفظ به عباده الصالحون	Positive
اننا نعيش في زمن بلا رحمه	Negative
اللهم لا تكلنا الى انفسنا طرفه عين	Positive
بدعى على طول بان الله يرزقنى الخشوع	Positive
اذا غلبك امر وعجزت عن التعامل معه فكرر يا حي يا قيوم برحمتك استغيث	Positive
افشو السلام بينكم	Positive
الله يتقبل صلاتنا	Positive
لكل مجتهد نصيب .. من لديه هدف ويثابر عليه حتما بعد امر الله سوف يصل	Positive
اللهم اصلح حال المسلمين اجعلهم من الرباتين حتى نحرج مما نحن فيه لانه ان خلصت النوايا صلحت الاعمال	Positive
افعال لا تضاهيها اقوال	Positive
صراع متصاعد للهيمنه على سوق الالمنيوم العالميه	Negative
اقسم بالله انه منتهيي	Negative
يارب اجعلنى من الصالحين	Positive
يعني بكل وضوح بدكوا تذلوا الشعب الاردني تخلوه كل شهور يصف طابور عشان يوخدلوا اكمن ليره	Negative
سبحانك ربنا الواحد الاحد لا شريك لك تحيي تميت انت على كل شيء قدير صلى الله سلم على نبينا محمد على اله صحبه اجمعين	Positive
لبنان وزبالتوا	Negative
جهنم وباس المصير	Negative
بارك الله لكما وبارك عليكما وجمع بينكما على خير	Positive
وجه الفطيره قبل تعيب الناس انظر الى حالك	Negative
صوتك وحش	Negative
كلامك يشعرني بالتفاؤل يمدني بالقوه الاستمرار	Positive
الاردن كان افضل حالا بمئات المرات في التعليم و الصحه و الزراعه و الاستثمار .. التردي ليس مرتبط بالربيع العربي بل قبله بمده عام	Negative
لما اجد فيها الا الجراح	Negative
الموضوع ما اله علاقه بالتخلف بس لما تكون الاضرار اكثر من الفائده بلا منه ا?هم من هيك انه المفاعل بحاجه لتبريد دائم للاسف وين المي يلي عنا؟؟	Negative
اللهم معنا علي طاعتك ورضاك وقوي عذامئنا	Positive
يا ارحم الراحمين يا الله	Positive
فانا اناشد الحكومه الاردنيه بالافراج عن اسرى السلفيين التوحيدين الموجودين في سجونهم	Negative
شاهد تحرش جماعي بسيده تحمل طفلها على كورنيش	Negative
مش فاهم عليك لانك صاير غير مفهوم	Negative
صباحات النقاء الابتسامات الصافيه من القلب	Positive
لا يغير الله ما بقوم حتى يغيروا ما بانفسهم	Positive
قول يارب ادعي كتير انك تكره هذه المعصيه وربنا كريم	Positive
بس الله لا يسامحكم تلقوها بصحتكم ان شاء الله	Negative
مقاسك غير مناسب يا شريف مع نفسك	Negative
مش طبيعي سماكه الدم شو ها عدوله خرب المفطع لشو المبالغه والاوفر يعني	Negative
فالاول يصحح مساري الثاني يزيد من اصراري	Positive
حرام والله حزنت عليه شو هالموقف الشنع	Negative
صباح الخيرات والعبادات	Positive
طول عمر بخاف ان امثالك يصبحوا مطربين	Negative
اللهم ثبته على دين الاسلام اللهم يا مقلب القلوب ثبت قلبي على دينك	Positive
مشتاقه لك شوق ماحسه الناس شوق يغطي معاليق الروح بضمي ترف دلع لهفه مشاعر واحساس ماابي غيرك ولاغيرك تراه همي	Positive
نهارك طيب مبروك	Positive
يلعن ام السخافه	Negative
ايه الهبل دا	Negative
ان المعلم الذي يسعى للتطوير والاستزاده هو الاقدر على غرس الالتزام والطموح في طلابه	Positive
الى جهنم وبئس المصير	Negative
الف مبروك تخرج ابناء الظفير من الكليه العسكريه الملكيه من الاردن	Positive
القتل نهايه الزوجه اللعوب	Negative
خرى عليك	Negative
والله احلا شيء انه الواحد يهاجر او يشتغل حرامي عشان يقدر يعيش الله لا يوفق الي كان السبب الله حرام	Negative
بارك الله فيك نتمنى المزيد من النصائح	Positive
الحكم سيئ	Negative
ثكلتك امك	Negative
ربنايحفظك ياشيخ	Positive
الله لا يعطي العافيه ولا الصحه للاخوان المفلسين	Negative
التخلف بعين امه وعين ابو في جامعات الاردن والزعرنه والفساد والفسق والعشق الممنوع	Negative
مسوي انه مندهش	Negative
ضع امنياتكم في سجده انساها وتاكد ان الله لن ينساها ابدا	Positive
بالله عليكم الم تستحيوا من انفسكم قبل قدومكم الى هذا البرنامج ثم الم تعلموا ان هناك مسابقات لانكر الاصوات في قناه اخرى	Negative
والله انكو ما بتخافوالله	Negative
من بغضه رب العالمين لن يحبه احد	Positive
الله ينتقم منه حمزه منصور واعوانه حسبنا الله فيهم	Negative
الخشوع امر مهم جدا في الصلاه	Positive
صباحكم نقاء يشبه سيرتك	Positive
الله يهدي الجميع للاسلام	Positive
ينور عليك ويكثر من امثالك	Positive
استغفر الله مجانين يروحون سوبر ستار	Negative
وقعنا ولا ما وقعنا يللي بدهم يعملوه بيعملوه	Negative
يلعن ابو هل الاشكال بس	Negative
مثال جميل جدا عبره لكل من يحمل رساله الاسلام	Positive
ان النجاح يحتاج الي قلبا ثابت عقلا راشد طموحا واعد تحدي كاسر	Positive
دار الزمن وصار الوسط الفني كله نفس ذي العاهات ووضحكو هما علينا	Negative
عفكره البيج هاد قرفني وقلب معدتي شو للاسف انتا انو عرفك انه هيك الوضع بتفتح بالفنجان يا ناس خفوا علينا الدين مش للايكات وكمنتات	Negative
كرامتى اولى	Positive
ماجمل الحب الاخوه في الله ان نخاف على بعضنا حتى في علاقتنا مع ربنا شئ رائع جدا	Positive
لا حول ولا قوه الا بالله ليش الحرج هدا	Negative
هذا هو الحب الاصيل الوفي بكل معنى الوفاء	Positive
ما اروع برنامج الطريق الى الله	Positive
فاشله من بيئه فاشله	Negative
والله تحشيش من الاخر	Negative
رح اجتهد باني اكون حلوه يوم عرسي مش اكون مثل القرده	Negative
العرب مو بتاع هي الشغلات لاكن نحن فاشلين الله معطينا كل متطلبات التحظر والتطور لاكن نحن لازقين بهلتفاهات ونضن انو هي التحظر	Negative
ولك تفييه عليك	Negative
الله يرزقها كل مشتهي يا رب	Positive
متهور وكذاب	Negative
مين بشار العاهه هاد الي بهدد اي عند الجد والله للنساء والبنات تتطلعن قبل الرجال في هالحاله ونلعن ابو الساعه اللي طلعت بشار وغيره شو هالحكي الاردن قوي بجيشه وقائده فعلا هززلت قال سوريا قال ولا النعامه او رقبه عاليه بدهها قص	Negative
لى جماعه الاخوان الخسيسه كيف بدكو الوطن يتصلح وانتو قسمتوه لفريقيين كل واحد منكم اخدنا لمطرح ومش عارفين واصليين لوين	Negative
هما بس الى بيسعوا للغناء ده طبعا غير الاشتغالات والافلام الهندى الى نحن شفنها	Negative
اللهم اعنا على ذكرك وشكرك وحسن عبادتك	Positive
ما في احلى من الفرح	Positive
ايه راحه فيها المسكين ياحرام	Negative
ما اروعهم	Positive
كن مع الله لا تبالي	Positive
ان الله هو الرزاق دو القوه المتين	Positive
نعم الصديق الوفى	Positive
اني احبك في الله	Positive
من يتقي الله يجعل له مخرجا	Positive
شعور الانفصام تاع سنه خامسه كثير بخزي! اللي هو انك عملت كل شي ممكن ينعمل بالجامعه فزهقت وبدك تتخرج بس بنفس الوقت مش هاين عليك تترك الجامعه	Negative
صار عناد وكره قله ادب بس ظلموها	Negative
قلولهم هذا سوبر ستار مش مسابقه لبياع الخضار	Negative
ستجد مساعده الله وعونه لك عندما تكن النيه صادقه	Positive
وش جابني هنا ثقيلين دم	Negative
ليت بعض الذكريات ينعمل لها فورمات	Negative
شو بالا يا دانيا المشكله مش عارفه تكتب هعهعه	Negative
شكرا لك	Positive
يا هيك الاكل يا بلا لش الحكي	Positive
شي مؤكد انك حمار	Negative
الله يسعدك يبعد عنك كل شر	Positive
بكره واحد منهم بينتحر لم يضحكو عليه	Negative
كانت العرب في الجاهليه، يصيبها التشاؤم ان رات رجل او امراه لون عينيه ازرق وكانت تعتقد انهم شياطين او مس شيطاني اصابهم وهم اجنه	Negative
من وين انجيب حرام عليكم	Negative
كباب كباب واخرتها لحم كلاب تكرمون ، احذروا	Negative
لو حد يا جماعه يعرف طبيب اذن يدلني ولا شكلي هارميهم خلاص باظو	Negative
فهم ادرى واخبر لا وبل اكثر انكارا للشيعه وامثالهم	Negative
انا احب هذا الكاتب	Positive
كنت اخادع الحياه لكي اعيش كما اريد لكن الحياه خدعتني عشت كما هي تريد	Positive
الله يثبتك ينور طريقنا	Positive
ولو هو انسان وعنده احاسيس ممكن من هالموقف اللي الكل يشوفه يتعقد هالانسان من حياته كلها	Negative
اللهم اعصمنا عن معصيتك	Positive
طالما انك تتوجه الى الله عز وجل باستمرار فلسوف يفتح عليك اكثر مما تتخيل	Positive
اللجنه ما تنطاق	Negative
يا اخوان نحن قرفنا	Negative
الشو اسمو ستار اكاديمي ولا المسخره عل العالم اكاديمي	Negative
لو طلعتي من الاردن وين تروحي	Negative
مقرف جدا هذا الشخص	Negative
اسال من بيده ملكوت السماوات والارض ان ييسر لكم اموركم ويرفع قدركم ويعلي شانكم ويبارك لكم فيما اعطاكم ويصرف عنكم ما اذاكم	Positive
من قلت الذوق هذه الافعال	Negative
من جد سوبر ابقار	Negative
اللهم اعني على ذكرك شكرك حسن عبادتك	Positive
صباح الاماني الجميله المحققه باذن الله	Positive
حقا مزبوط صدقت	Positive
عجل يا الله	Positive
وذلك ليذوقوا ايران وسوريا وشيعتهم وبال امرهم	Negative
قصدك اخر ما توصل اليه العقل البشري من تفاهات	Negative
جميله اوى اوى اوى يارب الكل يحس معنى الكلام ده	Positive
صباح الابتسامه مرسومه على محياك ربي اجعل حياتي حياه احبتي نور على نور	Positive
والشكرلله والفضل لله على هذه النعمه التي انعم الله علينا بها وجعلنا من الماء كل شي حي	Positive
اكيد جزاك الله خيرا	Positive
يلعن شرف خواتك	Negative
بقطعكم شو حقودين	Negative
انا متاكده انو هذولي مدفوعلهم علشان يجون يغنون لانو مافي ناس مهابيل لهالدرجه	Negative
انا فعلا عملت كده والحمدلله بقيت احسن من غير الحجات الي ربنا خدها مني الحمدلله	Positive
اصلا المغتربين ماعاد بدهم جامعات الاردن، عل فكره في دول ثانيه وجامعات ثانيه اقوى، خليها للذنيبات	Negative
حرام تحمل اسم عظيم زي هيك	Negative
اللهم انر قلوب المسلمين ايقظهم من غفلتهم	Positive
هذه من اقوال الرفيق المناضل	Positive
اصلا هدا يمسى مرض الرهاب الاجتماعي	Negative
هذا ليس مضحك بل مخزى يا للخزى العار	Negative
ومن منطلق المسؤوليه التاريخيه للهاشميين تجاه المقدسات ياتي اهتمام الهاشميين بالقدس ومقدساتها	Positive
صباح الخير والسعاده لكم	Positive
بسمه امل حلوه	Positive
صوره مليانه روح ، يعلم الله اني سعيد جدا فيها ففيها شباب حافظين لكتاب الله	Positive
دعاء جميل ماشاء الله	Positive
حفظ الله وطننا من المنافقين المتاردنين	Negative
المهم هو الصادق معي الناصح لي	Positive
ان شاء الله يتقبل الله صلاتنا يزيد في صلاتنا الخشوع	Positive
يعطيك العافيه	Positive
الله يرفعهم الى جهنم جنب القذافي باسرع وقت لان الظلم زاد عن حده	Negative
كلام جى فى وقته	Positive
يعني هيك برامج بتبين للناس وين صرنا كم صارت نسبه التخلف بين شباب امتنا	Negative
لا يشكي قله المال لكنه يشكو امانه الرجال	Positive
فلما الحزن فلقد اصبح الحزن صديقي	Negative
هاض بني ادم حقير	Negative
ما عندهم هو قله احترام للمشتركين وفله ادب تجاه المشاهدين	Negative
ظني بالله جميل	Positive
لا تحزن الدنيا ما فيها اشي تحزن عليه	Positive
نهارك اسود	Negative
اللهم احسن خواتيم اعمالنا اجعل كل اوقاتنا طاعه	Positive
ما احقر الاصدقاء حينما يصبحون غرباء فجاه	Negative
قلت ادب	Negative
صباح ملؤه الخيرات المسرات	Positive
ملحمه بالجامعه الاردنيه	Negative
دعواتك لنا يا شيخ سلمان بالتوفيق الفلاح الظفر حسن الخاتمه	Positive
الحمد لله رب العالمين على عطاه رضا	Positive
بس اكيد وراها مصلحه	Negative
ربنا المستعان ادعولنا ارجوكم	Positive
اصواتهم مع التوتر خربت	Negative
لله يحرق قلبك يبشار	Negative
يالا من هون كس امك انت و هو، بلاش قرف و وساخه	Negative
النيه دايما بتكون موجوده وربنا المعين	Positive
اسال الله ان يرزقني من يدعو لي في ظهر الغيب	Positive
مالكيش حظ في اصحابك ولا اهلك	Negative
الغباء واضح	Negative
اكبر مشكله تواجهكك في الاردن ؛ اذا طلعت من الدار شبعان ، بتعرفش وين تروح	Negative
ولا خير في امر كرهت ان يطلع عليه الناس	Negative
قل لي من تصاحب اقول لك من انت	Positive
رئيس مو عارف يحكي حرف الاس روح تخيب ولك يلعنها انيسه على هيك جحش خلفتو	Negative
الحمد لله الذي بنعمته تتم الصالحات حمدا غير منقطع	Positive
وعرض اختي انك لاسع يادمن عساس لو بدها تضرب من هسه خايفه منك	Negative
مقال رائع والله يهدي البنات يارب ويرجعهم للصواب	Positive
احس انه يفطر حشيش	Negative
اللهم لا شماته ليش ياربي يحرجوا انفسهم	Negative
لا تقنتوا من رحمه الله فهي وسعت كل شيء مهما عصينا فلنا رب كبير رحيم ورحمن	Positive
الله يرحمنا برحمته	Positive
من ضحك عليك وحكالك صوتك حلو	Negative
اللهم نسالك السلامه من مثل هذه الخيبه	Positive
متفقين معهم البرنامج خايس	Negative
لتصل الى القمه لا تلتفت الى مغريات الطريق	Positive
احيانا يكون الفشل دافع للنجاح	Positive
عد دراسه قمنا بها تبين ان وضع خلايه شمسيه في صجراء الاردن والسعوده تكفي للاناره الارض كامله مدى الحياه	Positive
يضحكون م شاففوا انفسهم لو قلنا غنوا جابوا الععيد فالحين بس في الظرافهه الشيبان	Negative
الظاهر عقلك تافه من اصحاب العقول المقفله	Negative
تليفيزيون المستقبل صار سيء للغايه ما ادري ليش	Negative
اللهم اجعلني من يتشرف به الاسلام	Positive
اهلا وسهلا بك بيننا يا طارق	Positive
غيب عن وجهي	Negative
لاتنساني من دعائك الصالح شيخنا	Positive
مالك دين مثل الكلاب الضاله الا اقولك مثل مومسات عاهرات المراقص عندكن	Negative
اللهم ارزقنا كما ترزق البغاث تسلميلي هنوده حلوه كثير الله يفتح عليكي يهدينا اياكي	Positive
البيت اللي فيه فرح سعاده دايما بكون متفائل سعيد بحاضره مستقبله	Positive
اللهم اعنا على انفسنا اجعلنا نرى الدنيا صغيره الاخره كبير	Positive
اصلا كتير من البنات بدهن يحكن مع الشباب	Negative
اذا لم تقل لا للظلم فسيستمر الى الابد	Positive
اليك يا ربي قلبا لم يستعن بسواك، ياوي اليك لترضى ويهتدي بهداك	Positive
الجيل الي هيحرر فلسطين شوفه في سوريا يقاتل العلويين الكلاب لكن ربي يعلمهم فنون القتال ويربيهم	Negative
ويحطمو رؤوسهم بارجلهم	Negative
ما اسخفك	Negative
فيديو بايخ	Negative
نسيانك صعب اكيد	Negative
انا انصح كل انسان ان لايكذب لان الكذب مداه قصير	Positive
الحمد لله على نعمه التي لا تحصى الحمد لله الذي تكفل برزقي الحمد لله لانه رب يستحق الحمد على السراء الضراء	Positive
نعم فى البدايه كلهم اروع من الروعه	Positive
والله عاهات	Negative
رجعتولنا الفرحه اللي نسيناها	Positive
انت ما تستحي تقارن القران بوحده ساقطه انعل ابوك لا ابو الملحد	Negative
اللهم ارضنا بما قسمته لنا	Positive
لجنه حكم ماعندها ذره احترام	Negative
يتسابقون الى جهنم و باس المصير	Negative
لو كاكا بالبرازيل كنت اعطيط لايك بس هيك فشر	Negative
صباح الزنبق والفل والياسمين	Positive
مش عارف كيف الناس بتحبك يا زلمه؟	Negative
برك الله فيك وجعلها في مزان حسناتيك	Positive
شو عادي يزم انتا ما عندك دم ونخوه يزم انتا مش بني ادم ترى ورح طير	Negative
الله اكبر والعزه للسلام	Positive
حينما ننجح فى الانتصار على انفسنا	Positive
ما شاء الله العطله ماثر عليكوا كتير صبايا الكل بحكي حبيبتي وحبي وبلمدرسه كل واحد بكشر من جهه	Negative
الله يوفقكم والله يجعلكم تفوزون كلكم معنا قولوا امين	Positive
اللي لازم يصير اضراب جميع موظفي الدوائر الحكوميه الخاصه لمده اسبوع شوف بعدها	Negative
يا رب يا خير الرازقين ارزق اهل سوريا جميع المسلمين النصر الثبات التقوى	Positive
لوين ندكم توصلونا الله هموم المصاريف قتلت الصغير قبل الكبير الله ياخذ حقنا منكم لا يباركلكم	Negative
الله يهدي التائهين والضالين الى طريقه	Positive
اللهم هون برد الشتاء على عبادك المستضعفين في كل مكان ،اللهم انزل دفئك ورحمتك على كل فقير لا ماوى له	Negative
اللهم اكرمنا برضاك	Positive
اوقف القرار للحفاظ على الوطن	Negative
يارب قربني اليك واقترب لي اكثر	Positive
الحمد لله كلما ارى ناس اسلموا تعم الفرحه في قلبي	Positive
ياخي برنامج سامج ساذج	Negative
بعدين الاردن تسبح على بحر من النفط الصخر الزيتي اشتغلو فيه بالاول بيكفينا 100 سنه	Negative
تويتر صاير ممل	Negative
كان خطاي الوحيد، اعطيت من لا يستحق اكثر من حقه	Negative
ربنا يستر واخلاق المتاسلمين لا ترجعه مره اخرى	Positive
ولا مستحيل يطلع واحد يفشل نفسه كذا	Negative
الله يفرح الكل ويجمع بين المتحابين على خير	Positive
خساره فيك اسمك :	Negative
الوفاء في غير قلبك ما لقيت	Positive
كلماتك عذبه	Positive
صرماتي براس اهلك	Negative
اللهم انا نشكو اليك ضعف قوتنا قله حيلتنا حسبنا الله نعم الوكيل	Negative
لو نريد الخشوع حقا نطلق الدنيا	Positive
اقرفني والله	Negative
الابتسامه كلمه طيبه بدون حروف	Positive
عليكم بالدعاء والتضرع لله سبحانه وتعالى ولا يرد القضاء اللا الدعاء اجتهدوا رحمكم الله	Positive
ربنا يكتر من امثالك يا مصطفى	Positive
اللهم اصلح حالي احفظني نور قلبي اجعل طريق الخير طريقي اجعل عملي خالصا لوجهك الكريم توب علي اغفر لي زلاتي	Positive
نجدد قلبنا بالايمان مع بعض	Positive
لا حول ولا قوه الا بالله العظيم لم اكن اعلم ان نسبه ذكاء العرب منخفضه جدا الى هذا الحد	Negative
صباح الورد لوجه طيبه	Positive
الصادق ينتظر الفرج ولا يياس من روح الله	Positive
حلو كلامك عزيزي	Positive
الاهم نكون صادقين مع نفسنا لنكون صادقين مع الاخرين	Positive
ليس هناك شخص معاق بل هناك مجتمع يعيق	Negative
لا تحزن على دنا فانيه بل احزن على اخره باقيه	Positive
صباح الحب من الله علينا جميعا	Positive
من ترك شيئا لله عوضه الله خيرا منه	Positive
و يرزقكم من حيث لا تعلمون	Positive
سوبر سطار ولا بلاش	Negative
كسم البرامج العربيه متخلفه بنت شرموطه	Negative
حسبنا الله ايش صاير لشبابنا الحشيش والمخدرات غزتهم الله يهونها ويحفظ شباب وبنات الاردن	Negative
حرام عليك ماتشوفه شلون يصارخ كانه مشجع في ملعب	Negative
اتصور لو ظليت ما اتعلق احسن لانه تعليقاتك مقرفه	Negative
والله قررات من دلواتى يا مصطفى بس انا عاز رايك فى حاجات كتير	Positive
ما حد بيتحكم فيي	Negative
الله يخزيكم عند امن الوطن مافي سلطي ولا كركي ولا طفيلي الاردن فوق الجميع قالوا بنحبك يا وطن رد عليهم الوطن بغصه حبوا بعضكم اول	Negative
الله يسعد كل البشر امين يا رب	Positive
بعن الله ابوك انت وعدوله يالسامج	Negative
لا هديله بالجزمه طبعا	Negative
فعلا برنامج ساقط واللي بيتابعه اسقط منه	Negative
الاردن كثير حلوه من كل النواحي.. طبيعه و معالم و اثار	Positive
كيف يجتمع ستر وغض البصر	Negative
اللهم اجعلنا منهم وارزقنا الطاقه ولاراده لزللك ياربى	Positive
صباحكم سعاده وعباده مقبوله ان شاء الله	Positive
جورج وسوف حلب مو طبيعي	Negative
هدا ماهو عقل هدا تخلوف	Negative
وين الماء كل يوم الميه مقطوعه	Negative
حسبنا الله نعم الوكيل في اناس همهم تجويع الشعب	Negative
يا رب اريد تجديد ايماني ساعدني	Positive
طبعا اكيد والف	Positive
نتفق معك في ان الرجال يعرفون بالحق ولا يعرف الحق بالرجال	Negative
نعم الاخ و الصديق اخلاقك تدرس	Positive
الحب بين الزوجين اوسع ابواب السعاده	Positive
رحمه الله رحمه واسعه واسكنه فسيح جناته .. نعم الدكتور ونعم الداعيه ونعم الاب ونعم الصديق URL مخلص في عمله .. صدوق في دعوته	Positive
بنحاول فى كل مره نكون افضل	Positive
انا كل يوم اقول غدا سوف اصلي لكن لا اقدر انا ادعوا الله دائما ان يهديني ارجو من من يملك حل مراسلتي	Positive
لو يبطلو سرقه بهالخزينه الله الشعب ليعيش لكو ارحمونا حرام عليكم	Negative
بدك الصراحه بدون زعل جهنم الزبانيه من الملائكه تنتظرك تموت لتشرب من فروج المومسات صديد اهل النار ان شاء الله يا اوباش سوريا	Negative
الدعوه مش بالكلام بس ممكن نكون دعاه باخلاقنا اسلوبنا تعاملنا	Positive
يعني يجبون كم واحد يعطونهم فلوس ويجون يستهبلوا عندهم عشان يحركون البرنامج	Negative
يا الله ارحم عبدك الفقير المسكين وجميع المسلمين والمسلمات	Positive
اللهم عفوك رضاك الجنه	Positive
اعمل ليومك غدك كن متفائلا دائما يا صاحبي	Positive
زاكى اكيد رهف بكفى انه من مشتقات الحليب	Positive
ربنا يتوب علينا من المعاصى	Positive
الحب الان بقى تيك اواى قليل اوى لما نلقى انسان مخلص فى حبه مع ان الحب ده اجمل واسما عاطفه فى الوجود	Positive
اللهم لا تجعلنا من المنافقين	Positive
وين بدهم يروحو يعني خالصه	Negative
اميره ممكن اضافه لو سمحتي	Positive
يجب على الحكومه العوده بالتوقيت الى الساعه الثالثه	Negative
تكالبت عليه الكلاب ولم تسمح له بالبروز بعد البرنامج	Negative
شعوب تافهه همها الحياه الدنيا فكروا في نهايتكم	Negative
والله حرام الناس مش لاقيه توكل حتى ترفعو البنزين	Negative
هذه مشكله الذي يغني كثيرا في الحمام ويتصور انه اصبح مطرب	Negative
المغرب بريء منك على الاقل اذا كنت لهجتنا صعبه فتكلم باللغه العربيه	Negative
قمه البلاغه	Positive
الحمد لله على نعمه الاسلام وكفى يها نعمه	Positive
اللهم اني اسالك فعل الخيرات و ترك المنكرات و حب المساكين و ان تغفر لي و ترحمني و تتوب علي	Positive
ايوه هيك بدنا ياكم يا شباب بترفعو الراس	Positive
ما اجمل الحياه برضى الله	Positive
هو فى حد اساسا لسه بيتابع البت دي هاي عنجد بتقرف	Negative
ما ازنخك انت مقالاتك	Negative
نعم والحمد لله	Positive
وجه حسن وضحكه تفتح النفس وعيون خلابه	Positive
و اذا فادنا بشي رح يكون في خساره كبيره بالاخر	Negative
ربي يهديهن	Positive
شو عاجبك فيها مثلا ؟ لتكون سيارتكم	Negative
تفائلوا بالخير تجدوه اعملوا الصالحات	Positive
البرنامج الي بعد سوبر ستار الي يقلده دم ثقيل	Negative
مجانين احد يضحك عليك وانتم قدامه وتكمل	Negative
لو يدرس في جامعات مصر او الاردن يعرف الدراسه والعلم الحقيقي وهناك اللي يقدرون نسبته وتفوقه	Positive
اللهم لا تدع لى ذنبا الا غفرته اللهم اصلح لى دينى	Positive
بني البرنامج النووي الاردني على عده تصورات خاطئه بشكل خطير تتعلق بالتكنولوجيا	Negative
للاسف لسا في مدارس بتخلخل عظام الطلاب من البرد عن مدارس قرى الاردن و المناطق الشعبيه عم بحكي	Negative
يلعن الساعه الي بشرت فيك	Negative
بصمات راقيه لاديب الدعوه محمد الغزالي	Positive
الله يصبحك برضاه	Positive
دي اخلاق السلف الصالح	Positive
يا ريت لو يعملوا دورات قبل الزواج	Positive
اضحك تضحكلك الدني	Positive
اذا الخبر صحيح انا اول شخص بطالب بالهجره لاي دوله خليجيه او اوروبيه او حتى اسرائيل	Negative
وانا من الناس اللي فعلا محتاجين يحاسبوا نفسهم ويصلحو من نفسهم لاننا عارفين انه لا ملجا لنا الا لله	Positive
يارب اعيني علي دكرك وشكرك وحسن عبادتك	Positive
الاردن لديه الخبره في مجال اداره الموارد البشريه واستخدام هذه الامكانيات بافضل مايمكن لتوجيه اقتصاد الدوله	Positive
نعم احسنت واجبه على كل مسلم وحق لكل مسلم فتح الله عليكم	Positive
رضيت بالله ربا وبالاسلام دينا وبمحمد صلى الله عليه وسلم نبيا ورسولا	Positive
صباح العسل	Positive
ونعم بالله من اختار قرب الله فما خاب ابدا الله على دى راحه وده شعور الحمد لل	Positive
صراحه بخزي من دون مجامله	Negative
الحكومه قاعده بتخبص رايحين يدمروا البلد الله ينتقم منهم	Negative
حقيقى لازم نجمد قلبنا عن اى حاجه غلط	Positive
الله يستر على بنات المسلمين جميعا	Positive
يا رب قويني علي نفسي يا رب تقبل منا الله	Positive
سبحان الله قادر على كل شىء	Positive
اللهم ارنا الحق حقا ارزقنا اتباعه ارنا الباطل باطلا ارزقنا اجتنابه	Positive
اي والله سوبر	Negative
ربنا يوفق الجميع علي الخشوع	Positive
يا رب استجب دعائنا وانصر اهلنا في سوريا	Positive
صحيح انك سافل	Negative
من يوم شفتك حاطه صورتك غسلت يدي منك	Negative
يازم والله ماعندكم غير الكذب ع الناس	Negative
سبحانك ربي اني كنت من الضالمين	Positive
الواحد عايش وسط قرف	Negative
اللهم ان كان لي عوض على صبري	Positive
اللهم ارزقنا السلامه العافيه في ديننا دنيانا	Positive
والله لو يجمعونهم على شاطئ البحر الميت ويخلونهم يصرخون على اليهود ولمده 30 ثانيه ليهربون لقبرص عن طريق البحر سباحه	Negative
يجب دائما ان نعتني بالورود لكي تكبر	Positive
ناقص و كذاب وما في مصداقيه	Negative
يا رب نستغفرك ونتوب اليك يا رب ما لنا سواك	Positive
كن انت التغير الذي تريد ان تراه	Positive
وهابي عفن ومكبوت تفكيرك محصور بين فخذيك فقط لاغير الجنه اللتي ستدخلها انت لا اريد دخولها جهنم اشرفلي واهون علي من ان اكون مع احد الوهابين المنحطين لواطيي الاطفال	Negative
عندما يقدم طلاب على حرق الكتب المدرسيه والاضراب فنحن نعيش انتكاسه في التعليم بطلها المعلم الغير مبالي الذين اججوا وافتعلوا الازمه	Negative
يارب احمينا من شرور انفسنا وسىئات اعمالنا	Positive
اللهم احفظني بحفظك حسبي الله لا قوه الا بك	Positive
كيف لا احبه و في كل مساء يهديني شيئا من روحه	Positive
اللهم اجعلنا ممن تنظر اليهم بحب اشتياق اجعلنا من عبادك التوابين المخلصين العابدين الحق لدينك احفظنا قنا نار وقودها الناس الحجاره يا رب	Positive
مش النووي ان صار وما اظنش اسرائيل تسمح باقامته بهالسهوله هو اللي بيعني انو نحن متطورين او متقدمين	Negative
لا مو حلو بخزي	Negative
واذكر ربك اذا نسيت وقل عسى ان يهدينى ربى لاقرب من هذا رشدا	Positive
الحلال بين و الحرام بين واتقوا الله	Positive
اتقوا الله فينا بكفي رفع اسعار الرواتب بالحضيض	Negative
الحمد لله اكسجين يعيد للصدر انفاسه ف تجدها الصوت السعيد الصوت المتئاكل من البكاء	Positive
تحطم ماتبقى من اطيافي	Negative
الله غلى المسلمين فى توادهم وتراحمهم	Positive
لانه النووي ضرره علينا اكتر بكتير من فوائده	Negative
والله هذا الى حصل معانا ومع ناس كثيره بدل حب الحرام بحب الحلال يبدل الله كيانك	Positive
تنظرون لا الشام يقتلون بدم بارد	Negative
الله عليك بجد رنا يهدينا كلنا ويهدي شباب المسلمين جميعا يارب العالمين	Positive
كنت اشوف الاجانب اقول موسوسين	Negative
الاكل زاكي كثير كثير	Positive
انني كومه من القلق والرجفه اكثر من كوني انسان	Negative
سوبر طقاع اول واحد جايته زبيريه	Negative
مستحيل اثق بذوق حدا ما بحب يسمع لام كلثوم	Negative
قول يا الله ده عنك مش بعيد متشلش هم ولا تشعر بضيق اقول يالله اهديني ياقلبي عشان اتوب امحي الذنوب واهديلي الطريق	Positive
فطست ضحك على الشايب	Negative
اهلا بيك فى دين الله ربنا يثبتك ويزيدك ايمانا انا فرحانه بيك كتير	Positive
الانكسار من اسوء الاشياء	Negative
واضح جدا ان اغلب الناس هاي عندها مشاكل نفسيه	Negative
انت واحد حقير	Negative
الغموض لغه لا يتكلم بها الا من ذاق متاعب الدنيا	Negative
حقيقه العمل التطوعي ، يساعد في القضاء على اوقات الفراغ ، يمنحك خبرات وتجربه جديده	Positive
ربنا يعنا علي كل شيء	Positive
سابقى رائعا معك الى النهايه ان بقيتي رائعه معي الى النهايه	Positive
اللهم زينا بالخلق الحسن ارزقنا الامانه نظافه القلب اللسان امين	Positive
اللهم اجعلني مقيم الصلاه من ذريتي	Positive
صحيح الابتسامه لها تعابير كثيره	Positive
الله يكثر الافراح	Positive
كرامتي افضل من سعادتي	Positive
كن انت ذلك الشخص	Positive
صباحات العقول اليقظه الهمم الحييه المتوثبه	Positive
وهاد اللي بخبص حكي ملوش معنا ابن مين هاد	Negative
حسبي الله عليكم الله بحاسبكم على كل حد بينفتن بسلبكم الله لا يسامحكم	Negative
الخشوع هو المرحله التاليه للتركيز والتركيز ياتى باطاله القراءه والتدبر واطاله الركوع والسجود	Positive
المراه كلها عوره حتى صوتها عوره	Negative
اين ذهبوا العلماء والمخترعين والمفكرين جرب في جرب	Negative
انا بكرهك	Negative
برنامج قديم	Negative
فاضل قلمين نخلص	Negative
والله ما يحرر عزبت بنقاليه	Negative
لسانك قذر يا قمامه	Negative
عيب يغني ده السادات وده ابن مره	Negative
قصه رائعه افادك الله من العلم لتفيدنا دائما	Positive
الي انا شايفو انو المفاعل راح ينعمل في الاردن راح يخدم دول تانيه يعني مش عشان سواد عيونا	Negative
اللهم اجعلنا من اللذين يصلحون فى الارض ولا يفسدون	Positive
ابشرك فيه تحسن ولله الحمد باذن الله يرجع قريبا	Positive
الغرب فسق وعائلات مفككه والنساء عاهرات،المدارس تعلم الجنس للاطفال يشربون الكحول وياكلون لحم الخنزير ثم يقول: وجدت في الغرب اسلام بلا مسلمين	Negative
انما بعثت لاتم مكارم الاخلاق	Positive
الفاشل من يياس ويقف عند اول حاله رسوب	Negative
اذا اردت ان يفتح الله عليك فالزم هذا الدعاء البسيط اللهم اجعل اﻷخره همي	Positive
انسان غريب	Negative
الله اكبر ما من دابتن الا على الله رزقه	Positive
يا ظالم الك يومك	Negative
الاسلام هو حسن الخلق الا تعرف بان الحبيب صلى الله عليه سلم لقب امينا قبل نزول الوحي	Positive
فعلا فضايح ما توقعتها في شبابنا المتخلف اخلاقيا وصوتيا وبدنيا اها وعقليا بالتاكيد	Negative
والله انك مهزله	Negative
من اين لنا المياه لتبريد المفاعل النووي فهو يحتاج الى نصف مليون مترا مكعبا من المياه لتبريده سنويا على الاقل والقاصي والداني يعرف اننا في بلد يعاني من شحه المياه اما كعلوم معرفه بالعلوم النوويه الطاقه فانا احب ان يتعلمها المتعلمين في بلادنا بدءا من جدول مندلييف للعناصر مرورا العناصر المشعه نظريه اينشتاين للطاقه نظريات الفيزياء الكميه البحث في عمر البروتون النيوترينو والكواركات واللبتونات وال النظائر المشعه تفتيت الذره اشعه جاما بيتا الفا الراديوم البلوتونيوم البروتونات كافه النظريات بما فيها انواع المفاعلات النوويه تجارب الامم فيها مثل اليابان المانيا روسيا فرنسا امريكا للعلم فقط انها علوم نظريا سهله بسيطه يستطيع فهمها حتى الانسان ذو الخلفيه الرغبه العلميه على جميع او على الاقل جزء من علمائنا ان يقرروا المسار الذي يجب ان نسلكه نسير فيه بهذا الخصوص بموازنه المخاطر المكاسب بعدها على اساس النتيجه الفائده الواضحه يتم الاعتماد لقرارهم ان كان سلبا ام ايجابا	Negative
من يتوكل على الله فهو حسبه	Positive
سالت اصحابي ف هذا المجال و حكولي غير URL مكلف. الكل باكد انه الحل لوضع الاردن الحرج هو طاقه نوويه	Negative
المشكله ناس بتسمع حالها بالحمام هيه وبتغني	Negative
ستضافتهم وعاملتهم معامله انسانيه ولم تحصرهم في مخيمات تفتقر لادنى مطلوبات الحياه مثل الاردن	Positive
صوته مره منبح احسه تعبان عاد زبدوله مابقى الا يطلع بعد شوي	Negative
يا رب اللهم اجعلنى خير مما يظنون اغفر لى ما لا يعلمون	Positive
فعلا اللي بيستحوا ماتوا	Negative
وش يحسون فيه يع	Negative
بارك الله في دين الاسلم	Positive
والله ثقف نفسك ده بيقول كلام زى الفل	Positive
يخسو الشيعه الخنزير	Negative
تضرب منك لعدوله	Negative
اللي لفت انتباهي الدبه اللي جنبها	Negative
وهابي تاج راسك يا اللي تاكل من وراك اذا في الوهابيه شئ مخالف لكتاب الله سنه نبيه اذكره لا تكون كالببغاء تردد خلف الناعقين لتثبت انك على الصراط انت في هوه الخراب طنت من طنوت سوريا	Negative
اللهم انا نسالك رزقا حلال طيبا مباركا يعيننا علي طاعتك	Positive
ما شاء الله الله يثبتك	Positive
اللهم اتم علينا مكارم الاخلاق	Positive
المسلم الفطن النقي يتصرف بما يرضي الله في السر العلن نسال الله عز وجل ان نتبع كل ما يرضيه عنا	Positive
عوام الشيعه بين ساذج ومغفل وجاهل ومتجاهل ولا يمكن لعاقل ان يظن ان عباده الله تكون بان تقضي حياتك بين لطم ولعن وتباكي	Negative
اللهم اجعلنا ممن ياخذون بالاسباب	Positive
الله يخزيك	Negative
صباح الورد والفل	Positive
مت عليهم حيطه هالانذال اصحاب الاجندات الخاصه الخارجيه العميله	Negative
والله كذب من سوبر ستار القذر هذا	Negative
اللهم لم شمل جميع المسلمين	Positive
اه لو لا القران لقلت ان انكر الاصوات لهذه الاصوات	Negative
بجد ربنا يبارك فى كلماتك بتوصل والله	Positive
يجب على المسلم ان يواسى اخوه فى الاسلام	Positive
اللهم اغننا بحلالك عن حرامك اغننا بفضلك عمن سواك	Positive
لست الافضل لكن لي اسلوبي ساظل دائما اتقبل راي الناقد الحاسد	Positive
كلهم معندهمش احساس	Negative
من جد مجنون	Negative
نت عايش خارج البلد عموما ان كان نقاشك فرد عضلات مافيه داعي اكمل حواري معك	Negative
مهيه خربانه ان شاء الله يعملو مفاعل قرد بطلت تفرق	Negative
الفاتحه علي ارواح الغلابه	Negative
عادي محنا اتعودنا على الرفع من يوم يومنا نحن ما بنعرف غير الرفع همه برفعو نحنا بندفع على حسابنا	Negative
في كل مناحي الحياه التكنولوجيا بديل عن البشر الا في التعليم التكنولوجيا تجعل عمل المعلم .. متعه لا بديلا عنه	Positive
وانا مع انو الطاقه الشمسيه هي البديل	Negative
صحح الخبر مش تحرير المشتقات النفطيه انما توليعها	Negative
اسخف لجنه تحكيم شفتها بحياتي	Negative
اللهم اهدنا الى صراطتك المستقيم	Positive
باذن الله بديت ولو مؤخرا بنفسى الحمد لله	Positive
احقر من هيك خيانه ما في	Negative
الطاقه الشمسيه هي البديل وليست الطاقه النوويه	Negative
مش عارف كيف اهلهم سمحولهم يقدمو في البرنامج هادول شغل بطون	Negative
البسمه سر من اسرار الحياه	Positive
انتم يا قطريه شن عارفكم السياسه انتم لاعندكم جيش ولا استراتجيه ثابته انتم عملاء امريكا يا خونه	Negative
رعب وخوف على وجهك ياجبان	Negative
عاهاتك يا وطني	Negative
صباح الفل الورد يا شيخ سلمان عطر الله صباحك بذكره شكره حسن عبادته	Positive
اصلن صاحب البرنامج ماخذ شباب الامه مصخره	Negative
وانت اسكت لا تتحطم	Negative
الله يبارك فيك لانك غيرت في صاحبتي كتير وهي من المتؤثرين فيك وهي اللي عرفتني عليك	Positive
كلام رائع وفي وقته وربنا قادر علي كل شئ	Positive
مياعه وسئاله من عدوله والي معو	Negative
قصه جميله ودايما انا بحب اسمع البرنامج	Positive
وبعدين تري مالقت دعم	Negative
بكتب اوراق الشجر يقول موهبتي وانا صغير الله يسامح اللي كاذب عليه	Negative
لاتحزن فان الحسنه بعشره امثالها الى سبعمائه ضعف الى اضعاف كثيره و السيئه بمثلها الا ان يعفو ربك يتجاوز فكم لله من كرم ما سمع مثله و من جود لا يقاربه جود	Positive
يا اخي وين ما تروح بالاردن تخطى مناطق الشخصيات المهمه بالبلد الباقي كله مكرهه صحيه	Negative
صباح الخير والفل	Positive
لاتتحدث بقوتك امام ضعيف ، و لا بسعادتك امام حزين ، و لا بمالك امام فقير، زن كلامك و راع شعور الاخرين	Negative
عني كل يعلقو الا انا	Negative
انا حاسه انه قلبى مليان وعامر بنور الله	Positive
الله يبارك لنا فى ايامنا	Positive
لا بقلو بيضه حكي فارط نحن الاردنيه ما حد بيطلع معنا براس	Negative
والله شوي وتجيني جلطه لما ماطلعت الاولى ذيك المره	Negative
اللهم اعنى على ترك المعاصى حبا فى نور وجهك	Positive
ناس عزيزه المعزه لهم غير فيهم صفات الصالحين العليه	Positive
بعدين حتى الدول الي اعلنت انهاء المفاعلات النوويه زي اليابان تراجعت عن قراره	Negative
كله رائع بجد ربنا يكرمك	Positive
ابو الشباب راعي العود ليش ماوزنه في البيت غباء	Negative
عالم فاضيه بيسمو الغناء فن بيشغلو الناس	Negative
الله يوخذكم	Negative
لا محاله اول شيء يحدث له بعد عودته للمغرب سيتم اغتصابه كالعاهره	Negative
صباح القشطه	Positive
تفه عليك وع شكلك اول ما نشهرت طلقت زوجها خنزيره	Negative
اللهم اغفر لنا انا كنا ظالمين ادخلنا الجنه سالمين	Positive
يشبه رغد مجنونه هيافاء	Negative
العالم العربي مليان عاهات	Negative
يارب انت المستعان فاعنا واهدنا يارب الكون اجمع استجب	Positive
احلى شىء النهايه الباقيه صح كلامك	Positive
والله الحياه كلها بتخزي بدونكم	Negative
انا مع الاخ محمد سلامه بهالموضوع	Negative
ولا بقلو بيضه	Negative
صباحك نور	Positive
بياعين شرف	Negative
الله يلعن ام هيك نمر	Negative
حظ من ينعم بمحبه الصغار قبل الكبار ، لان محبتهم صادقه ومن القلب	Positive
جميله المعاني المجرده التي تنزوي عند التطبيق	Positive
يا عطاء يامنان يا اكرم الاكرمين	Positive
لا هديله بالشوز زى الصعيدى الى يكرمه الى ضربه بالشبشب ناقصه حراميه	Negative
بعرف حكايات مليانه عاهات مثلكم مجانين يا صيدات جورج وسوف	Negative
ابو معيتق قطع اوتار العود وقال السلام عليكم	Negative
الله على الكلام يا رب اعينا	Positive
ربي اشرح لي صدري و احلل عقده من لساني	Positive
احلى اشي الواحد يوكل بدون ما يطبخ	Positive
اللهم ارزقنا الصدق في طلب الاخلاص والاخلاص في طلب الصدق واجمع لنا بينهما بعفوك وقدرتك يا الله	Positive
ايس شراع القرف	Negative
اذا كنا بالفعل على موعد مع رفع لاسعار الخبز كما يشاع، فالاولى بالحكومه اولا ان تقوم بترشيد الدعم بحيث يذهب فقط لمن يستحقه!	Negative
ما شاء الله على هلتفائل الي عنده	Positive
اقسم بالله ان العرب اكثر الشعوب تخلفا	Negative
اللهم ارنا فيهم عجيب صنعك فانهم اذلو الشعوب	Negative
اسال الله عزوجل له الثبات	Positive
الله احفظ احبابي اصدقائي من الحسد الكيد الفتنه العين	Positive
الظاهر اهلها مفقعين وجهها قبل ما تجي ومغطيه الفلعات	Negative
اكيد طبعا حب ربنا احسن من حب اي حد وانا فعلا عملت كدا	Positive
كتكوت ضعيف الجناح الدنيا غدرت ها	Negative
عنجد بخزي	Negative
ربنا يكرمك على سعيك وحبك للمساعده	Positive
اسوا شعب الله في الكوميديا	Negative
صباح السعاده العامره	Positive
رغم انني اول من اثار فضيحه في المناهج المقرره في الاردن طوال عقود مضت ، و عوقبت بالفصل عده مرات من التربيه	Negative
و مفيش احلى من قضاء ربنا	Positive
اشي بقهر مش لا هل درجه	Negative
صباحك طيب كطيب المسك العنبر	Positive
ليش محشورين على بعض كذا خلصت الطاولات مالقو الا الطاوله الخايسه	Negative
اذا كان المدير يخاف من معلم مبدع وكان زملاء العمل يحاربون هذا المعلم فهم في الحقيقه ينتقصون من حظ طلابه	Negative
هذا تشهير ملعون والدين المفروض ما يعرضونه	Negative
انا متشائم رح اضل متشائم حتى ينزلوا البنزين	Negative
القدوه الحسنه خير من النصيحه	Positive
تايم لاين اردني واعي ومثقف لفت انتباه زين الاردن لتغيير محتوى تغريدتها شكرا لاحترامكم الراي العام في الاردن	Positive
ما بدي غير 10 يعملو لايك للبيج	Negative
متخافش يامؤمن قول يارب وحب ربك ده هو اللى خلق النعمه اللى انت متعلق بيها يعنى هو اعظم من النعمه دى وانت عارف كده	Positive
فعلا في البدايه كلهم رائعون	Positive
انت واحد ما بتستا هل الجزمه	Negative
و هكذا جنت على نفسها براقش	Negative
متسمم فكره الولد وصارت حالته صعبه يا حنين انت	Negative
برنامج ساقط	Negative
الى يقارن بينه وبين مرسى يبقى متخلف	Negative
هل تعلم ان المطر يتشكل اولا على هيئه بلورات ثلج داخل الغيوم يتحول الى قطرات ماء بعد ذوبانه هو في طريقه الى اليابسه	Positive
ربنا يقدرنى ويعفو عنى	Positive
هذول مخانيث	Negative
للاسف اصبحنا غرباء في اوطاننا اصبح الوطن وكانه ليس لنا اصبح الوطن ملك خاص لتاجرين والمتنفذين	Negative
لا تتهاون بحجاب زوجتك فهناك رجال في الطرقات في قلوبهم مرض يتمتعون بالنظر لنساء	Negative
استاذ غاوي غاوي اذا كنت غاوي المسخره روح اشتغل كراكوز	Negative
كله على راس المواطن ما يثير السخريه رفع اسعار المستقات النفطيه المستخدمه في الصناعه تقول صناعتنا مكسره الدنيا	Negative
يا طيب صباحك كل خيرات	Positive
اطمئن يا قلبى فرزقى لا ياخذه غيرى	Positive
تفو كس امك حماره	Negative
ضيعت دقايق من عمري بمشاهده ازنخ اتفه شخص بالحياه الا هو اللي بالنص لا حتى بعرف اسمه	Negative
وهذه من اكبر المشاكل التي تؤرق الشباب في هذه الايام	Positive
الدال على الخير كفاعله	Positive
الله يحمي البلد من كل مخرب والله يعطيكي العافيه رجال الامن العين السهره على حمايه البلد من اصحاب النفس المريضه انتم النشامى	Positive
حالات مرضيه نفسيه مستعصيه لا يستطيع شفائها لا العلم لا الفن	Negative
طبيب عيون اردني يسجل اختراعا جديدا في روسيا. كل يوم انجاز اردني يسجل. اﻻردن تكبر بابنائها	Positive
اللهم اعنا ترك كل ما لا ترضي	Positive
واحد هامل	Negative
انا لله انا اليه راجعون الله يستر هالبلد	Negative
ليش الطلاب فاضين يعملو مشاكل فاضين للدراسه يعني ما عندهم وقت فراغ للمشاكل	Negative
لا تعليق	Negative
مبرد وجوهكم	Negative
وان مدحتك بالقصائد ماوفيت	Positive
سخيف مره يمسخرون الواحد ومافي شي يضحك اصلا	Negative
الحمد لله ما اكرمك يا الله	Positive
لا ياعزيزتي انا عايشه بالمحكمه واشوف تسلط وظلم كبير من اشباه الرجال بس بالنهايه المظلومه تجد من ينتصر لها وبكل هدوء بدون افلام	Negative
يلعن ابو التفاهه	Negative
اقل من عادي هذا مستواك اقلب وجهك	Negative
قصه جميله تعلم الناس كمان الامانه لان اذا اخذ القليل اخذا الكثير	Positive
ما في احلى من التفائل الواحد بعيش مرتاح	Positive
قصه حقيقيه رائعه فيها عبره لكل زوج وزوجه فيها الموده والرحمه	Positive
اذا شعرت بشيء من حالات الاحباط والملل فجرب العمل التطوعي	Positive
خفي علينا يا حجه بلا مانسمع صوتك الناعم ويصيبنا صرع	Negative
الا يكفي ان نسبه مرضى السرطان في الاردن اعلى نسبه عالميه بسبب مفاعل دايمونه الاسرائيلي بكل جهل نضعهه في بلدنا	Negative
السعي وراء الرزق عباده و جهاد	Positive
ما اجمل من مثل هذا الحب الصادق الشفا	Negative
ارحمونا من الجوكر	Negative
مفيش اجمل من ان الانسان يحافظ على كرامته	Positive
انشالله انو يطلع كلام فاضي لانو اذا ضربت سوريا الاردن رح اتصير حرب عالميه ثالثه وما رح اتخلص غير لما نتخزق	Negative
اسعد الله صباحكم علامتنا بالخيرات	Positive
قرد زاني ابن حرام انقلع قبح الله صورتك ياخنزير	Negative
يارب عوضنا خير مما اخذ منا	Positive
انا دايما فرحان مش سائل بالدنيا الحمد لله	Positive
مع مرور والوقت وزياده الالتزامات والمسؤوليات قد تنسى ما كنت تستمع	Negative
اللهم احينا وامتنا على الاسلام وعلى كلمه لا اله الا الله	Positive
غبي من جده	Negative
الحمد لله نامل من الله ان يمن علينا بالهدايه	Positive
الاعتداءات على المعلمين والاطباء .. جرائم لا تقبل اي تبرير	Negative
شوف شكلك بالاول بعدين احكي	Negative
ربنا يهدينا يهدي بينا امه محمد الغافلين	Positive
الاردن هذا الي كله فخر واعتزاز لمدح مشروع الطاقه الشمسيه في الديوان الملكي كيف شعوره لو المشروع طاقه نوويه ؟! شو علاقه الفخر والاعتزاز ؟!	Negative
اصلا ابو وديع لو كان اجا كان خسر	Negative
نادرا ما بتصير لو انه الشعب بتطور وبيتعلم مع الوقت	Negative
اندهش لما عرف الحقيقه	Negative
ونعم بالله العلي العظيم ونعم بالله عزوجل	Positive
ضحكت طفل بسمه امل	Positive
الحل الوحيد حب الله ورسوله وطاعتهم	Positive
الله الله على اخلاق الصحابه اصحاب رسول الله	Positive
المعنى الحقيقي لعاهاتك يا وطن	Negative
عيب والله اسم المقطع	Negative
سنبقى دائما معا نشاطر بعضنا البعض مر الحياه وحلوها	Positive
قرف يعيع	Negative
اعنكم الله تقبل منكم يسر طريقكم	Positive
يشم الطيب ويتعطر يا دكتور	Positive
حيوان وكلب الله يموتك	Negative
كتير رخيص ومقرف	Negative
افلام الرعب تاثر على اطفالنا	Negative
اللي غنى عدوله محاوله استخفاف دم من البرنامج	Negative
اشداء على الكفار رحماء بينهم	Positive
والله نوفي صح لسانك	Negative
فى ناس كتير ربنا كرمهم بنعمه الاسلام ولكنها لا تدرك قيمتها	Positive
صباح الدرب للجنه و بلبل شادي بفنه و ريحه الياس و الحنه	Positive
هي عندها صوت قوي بس للاسف الحين مثل غيرها	Negative
يارب ثبتنا بعد اخذ القرار لان هو ده الاهم الاصعب	Positive
و الى اسماء الاسد كس اخت زوجك :	Negative
دمك ثقيل	Negative
طبعا واقع	Positive
اللهم اني اسالك خشيه في السر والعلن	Positive
الكرامه فوق كل شيء	Positive
الله لا يوفقكم محد يخاف علي من البرد	Positive
فعلا ان الطموح هو سر النجاح	Positive
اكيد بقرف	Negative
مين هاي الي بصوره وئدامها كورس	Negative
توكلت عليك يا الله	Positive
الله الله عليك يا استاذ عمر بارك الله لك بارك عليك جزاك الله عنا خيرا كثير	Positive
مين معو دوا للصراصير جد لازمهم رش مبيد حشري للقضاء على هيك حالات متخلفه	Negative
اعطيه علي راسي هدا الصح ياحاجه الله اكبر	Negative
اخبار مسخره	Negative
ما اضيق العيش لولا فسحه الامل الحمد لله	Positive
هذا اللي انت فالح فيه بس كيف تختار ضحاياك بالسرق جعل العاهه تصيبك ولاعاد تطيب منها ياولد الحرام	Negative
الملح احسن علاج لالتهاب الحلق ومفعوله اسرع من الادويه	Positive
حسيت كله تمثيل وسخافه غباء	Negative
نقطه النهايه وداعا	Negative
يا اخوان انتبهوا الى انه اكثر المشتركين المايعين من لبنان او سوريا وهذا حالهم لان تركوا مله الاسلام وتبعوا الميوع مع الشيطان	Negative
اربد فيها جامعات اكثر من عمان .. وفيها قد عمان ونص لعيبه المنتخب منها .. و 80 % من مطربين الاردن منها	Positive
لازم اخر ما توصل اليه العقل البشري من غباء اخوكم حمزه اللهواني من الاردن	Negative
اصلا سوبر ستار للعاهات	Negative
وياريت بتظبط الكذب ماوش رجلي	Positive
تيس مابفهم	Negative
ما اجمل الوفاء	Positive
غبي انتا اشي الصووت هاد بتشبهو بجورج وسوف	Negative
ربك دايما جنبك لو نديته هتلاقيه	Positive
قريبا ان شاء لله تسمع اخبار تسركم	Positive
كلامك جميل ورائع	Positive
من دون التفاؤل ما في حياه	Positive
ما يستحون هم جايين لو انا منهم اروح اقشر بصل	Negative
اللهم ثبتنا وثبته على دينك الحنيف وسنه نبيك	Positive
واثق من نفسه الحبيب	Negative
كلب واطي	Negative
اقرفني شعر تقول حاط دبر امل وجاي	Negative
جمال الصفحه من جمالكم رقي اخلاقكم انا متاكد ان صفحتنا ستعجبك فانضم الينا ادعو اصدقائك فنحن نسعد بك بهم	Positive
كلنا ما انتصرنا على نفسنا وعلى الحاجه ددي الي متعبتنا ومبعدتنا عن الله	Positive
ساعات اللى فى السر هو اللى بيخلى الناس تحبك فى العلن من غير ما يكونوا عارفين الا انهم بيحبوك من غير سبب	Positive
استعينوا بالله يا مسلمين	Positive
سلمت امري ربي عالمين رغم البعد احس ان ربنا رح يكتب ويجمعنا ويكون نصيبي	Positive
والله بذل نفسي مره اثنين خمسين عشان الغرام الحلال احلى لكن مين يحس يفهم يقدر	Positive
الغلط مو من المشاركين الغلط من نفس البرنامج المفروض تكون فى مرحله فرز فى البدايه قبل لا يطلعو الهواء	Negative
البقاء في الخيال دمار	Negative
في ايه يا ولاد الوثخه؟	Negative
اللهم امليء قلبي بحبك	Positive
لهم صارو يبيعو يشترو في البلد متل ما بدهم	Negative
وعجلت اليك ربي لترضي : كن كالمطر، اذا اقبل استبشر الناس به واذا حط نفعهم ، واذا رحل ترك اثرا نافعا فيهم واذا غاب اشتاقوا اليه .	Positive
ماشاء الله عليكم بجد موضوع مهم جدا والاهم الرقي الرائع في الحوار	Positive
وعلي الله قصد السبيل	Positive
كل النسخ العربيه والاجنبه كله تمثيل في تمثيل مسخره وعقول تاقهه	Negative
اترك ما تهوى لاجل من تخشى	Positive
المنتخب الايطالي عقيم هجوميا بعد ماكان منتخب يخشى هجومه كل المنتخبات	Negative
حرف الراء مصيبه ريس	Negative
الله على الظالمين	Negative
شكلك دايما متاخره عن المدرسه	Negative
اللهم اني اسالك صبرا	Positive
صباح الامتحانات	Negative
صباح العفو والتسامح صباح الخير لوجه الخير	Positive
هه انا من ناحيتي هاظ الانسان الي قاعد بلنص اقرف واحد	Negative
والله عيب بهدلتو حالكم	Negative
الوفاء اصبح شئ نادر يكاد يكون معدوم	Positive
كل البدايات جميله لكن العبره دائما تكون بالختام,اما كسبت او تعلمت درس مستحيل تنساه.	Positive
صح الصح كمان	Positive
انا بحب كل الناس بتمنالهم الخير	Positive
خبر عاجل يمنع لجميع المجانين التقدم الى سوبر ستار	Negative
ومن خسئ الشيعه اخوان القرده الخنازير	Negative
شبابنا فيهم الخير بس بدهم حدا يرشدهم	Positive
URL العرطه سمعناها قبل URL تصرف وسوبديلك اشي يرفع اقتصاد البلد	Negative
انتو كلاب ازى تسو المصحف بى كلابه زى ده	Negative
حبيبي شرلبوني يموت شرلبونا انا مدريدي? لكن ماني مغير لعيونه	Negative
لسنا مجبرين على تبرير المواقف لمن يسىء الظن بنا من يعرفنا جيدا يفهمنا جيدا فالعين تكذب نفسها ان احبت	Positive
لازم كل واحد فينا يفكر بشكل ايجابي يبعد عنه السلبيات	Positive
عنجد بخزي شو هاد على حساب ازياء طلع باله	Negative
اللهم القلوب الضاله	Positive
تقول داخله فيها ترله انحولت مع الاغنيه	Negative
مساكين ها البشر	Negative
اللهم اعز المسلمين	Positive
صدقت الله يا شيخ	Positive
ربنا يشفيهم	Positive
حماك الله من النكد	Positive
'عندما يقول لك احد: ابشرك فانك مباشره تفرح وتبتسم فكيف اذا كان القائل هو الله سبحانه وتعالى حين يقول : ''وبشر الصابرين''	Positive
صدقت يا رب اجعلنا راضين بقدرك	Positive
مزعج الي كثيير	Negative
ما فيها شك	Positive
مات في القريه قردا فاسترحنا من اذاه خلف الملعون عجوزا فاق في الخرف اباه	Negative
يارب ساعدني وقويني وساعدني اخد حبيبي	Positive
و الناس يدرون شو بقول عنهم في نفسي وهم يتكلمون ما يكلمني حدا نهائي	Negative
شو الاشي الي بيضحك ما ازنخك	Negative
اصدقاء اوفياء ونتعلم منهم	Positive
رهيب حسن تعالى تعالى	Negative
كلام حلو ومشجع	Positive
تماما اللهم لا تحرمنا الصدق في الكلام	Positive
مش شايف العالم مش ملاقيه الخبز كل واحد بشتغل على سياره رح يوكل هوا بارتفاع المحروقات الاكل الشرب رح يرتفع	Negative
اسال الله لك الاخلاص يا حبيبنا و اشتاق والله للصلاه معكم واسال الكريم ان يعيدكم الى منبركم كل عام وانت في خير وبخير	Positive
الارواح جنود مجنده من تعارف منها اتلف ومن تنافر منها اختلف	Positive
كس اختك	Negative
صباح الوفاء لك يا صديقي	Positive
والله الواحد بيدعي كثيرا ان ربنا يجعلنا في طريق مستقيم	Positive
زهايمر وخرف وحبتين كبتاجون	Negative
انا توجيهي سعودي و بدرس بجامعه من احسن جامعات الاردن ، و الشعب قاعد يعيد توجيهي و يرسب من ورى الوزير	Negative
ودي اكسر الابتوب على راسه	Negative
اللهم ارضنا و ارضى علينا	Positive
اللهم انى اقسمت عليك بك ان تهدى شباب المسلمين وتنور قلوبهم كما انعمت على طارق بنعمه الاسلام	Positive
عمدا فيهم ما نستعمل التدفئه نلبس فروه	Negative
شو هالغباء فضحتنا	Negative
سافل و غشاش	Negative
يا رب بناتنا شبابنا كلهم يستطيعوا العمل بهذه النصيحه يا ريتا كلنا نتذكر اننا كلنا دعاه للاسلام باخلاقيتنا الصفات الحسنه	Positive
اموت بصوتها	Negative
ما بكره حد قدك	Negative
والله على بالي مجنون	Negative
تخسا هما وكل واحد بشد على يدهم مشكلتو شعب سوري يدعون البراء وهم في قمه النذاله	Negative
الحمد لله الحمد لله الحمد لله حمدا شاكرا ففضلك ربي	Positive
كل شئ في حب الله تهون وحب ربنا اقوى بكتير من اى حاجه	Positive
ادعي من الله ان يقوني علي طاعته	Positive
حسبنا الله نعم الوكيل فيكم في مجلس النواب الحالي الذي لا يمثل الشعب الاردني فهم غير سائلين عن الشعب يبحثون عن مناصب وزاريه رواتب خياليه بينما المواطن الاردني طفح الكيل معه اصبح لا يطيق الحياه	Negative
اطالب برحيل هذه الحكومه	Negative
يارب اهدنا وقوى عزيمتا الى ما تحب وترضى	Positive
شغل مشغول قرف يع	Negative
يا رب خد بيدنا يا جبرنا يا جبار السموات والارض	Positive
قال حكم قال	Negative
كلام جميل	Positive
هم اللي مصخرو انفسهم	Negative
يالله ما اروع هائولاء الناس	Positive
انا انجنيت	Negative
اللهم ارزقنا ان نكون مثلهم	Positive
احلى صباح من احلى شيخ في العالم	Positive
كيد النساء لولا مكر الرجال لما خلقت حواء بكيد عظيم	Negative
يلعن اخت المياعه والبياخه	Negative
صباحك مبروك عدوك مهلوك	Positive
الحمد انا متفائله جدا في كا امور حياتي ورح اضل هيك دائما	Positive
صباح الخير الاشراق الامل	Positive
ان من صفات الاسلام الامانه	Positive
صباحكم هلا و شوق و غلا ،، صباحكم نور و فرح و سرور،، صباحكم ذوق و قدركم فوق ،؛ صباحكم حب وسعاده	Positive
قرف يقرف اللبنانيين شو تافهين	Negative
عنجد هذا الانسان تافه وحقير	Negative
بالله عليك فين الاناقه في الناس اللي بتغني دي	Negative
خير الكلام ما قل دل	Positive
ترى هاي فاهمه موضوع الوطنيه غلط ترى مش لحالك اردنيه والله اعلم اذا انك اردنيه اصلا شغل سوالف حصيده	Negative
الك يوم يا ظالم	Negative
حلوه اوى الحمله دي وربنا يارب يكرمك وكل الي بيتبرعو	Positive
نظام اقتصاد الاردن فقط لا يتبع اي نظام اقتصادي موضوع، لا اشتراكي ولا راسمالي ولا اسلامي ولا مختلط.	Negative
كلام جميل الكرامه افضل ابقى للانسان	Positive
ما بقى للسحيجه اشي يسترزقوا منه ،فضائح شركه الولاء وموارد والفوسفات والفساد عادت الى الواجهه .	Negative
نسعى بكل همه وجهد للحصول على مصادر طاقه رخيصه تعزز من اقتصاد الاردن كون الطاقه تشكل ربع موازنه الدوله	Positive
صباح كل جميل في هذا الكون	Positive
فشلوه مره صدق انهم دلوخ	Negative
اقسم بالله قرف المريض نفسيا للابد يبقى مريض نفسيا	Negative
مشان الله حد يعمله هوشه بدنا نعطللنا شوي	Negative
اي الله صحيح اهم شي الانسان كرامته	Positive
كلام ما في جدل	Positive
كلمه حب عجبتنى جيت اقؤلها جرحتنى	Negative
شو نوع الحشيش ؟؟	Negative
صباحك ورد ياسمين معطرين بنسمات من الجنه يا شيخنا الجليل حفظك الله من كل سوء نحبك في الله	Positive
غرباء نحن حتي في احلامنا نعيش واقع ليس لنا فيه نصيب. .؟ نتمني اشياء كثيره لكن بدون ان نتحمل اي مسؤوليه. URL الى انفسنا فقط	Negative
لا عنجد زلمه شكلو بخوف	Negative
لا يوجد كفائات بالاردن قادره على اداره هكذا مشروع	Negative
ما اجمل الاخاء	Positive
شنو السالفه يعني اتقارنون القران الكريم ويه نجوه كرم هاي العرمه لا الله الا الله	Negative
هذا سلامي يسبق البرق الطير فيه الحروف معطره بالتحيه	Positive
سلام عليكم طبتم تقال للطيبين عندما يساقون للجنه وهم من طابت اقوالهم وافعالهم في الدنيا . اللهم اجعلنا منهم..	Positive
حلوه وهي ساكته اذا ابتسم كرهت شكلها	Negative
حطمت كل احلامي البريئه	Negative
المومين الى بعضهم كالبناء الزى يشد بعضه البعض	Positive
الله لا يشبعكو يا حراميه	Negative
اشرب من كاس المر	Negative
المشكله في ناس تقنع حالها انه جورج وسوف له علاقه بالاغاني	Negative
اللهم اهدنا صراطك المستقيم	Positive
الحمد لله الذي نصرنا نصرا مبين	Positive
عيش زي ما بدك ما ترد على حدا ابدا	Positive
واطي وماجور وسافل ومنحط وكريه وغبي وسطحي وحقو قرش مصدي وبيسوى صرمايه	Negative
لكن للاسف عنا كلمه معاق في الحياه العامه في الاردن تستخدم للتعبير عن الشخص الغبي علشان هيك انا قلت ذوي الاحتياجات الخاصه افضل	Negative
لان ديانا كرزون البغله الاردنيه لا تستحق ذلك	Negative
بجد موضوع رائع وانا اجد انه مناسب ايضا لهذا الوقت يارب احفظنا من جميع الفتن	Positive
استخفف من لجنه التحكيم	Negative
شعب لا يحركه هذا الظلم التعدي على كرامته هو شعب لا يستحق الحياه	Negative
مابتحكي معه هيك انزلع لاعاد اشووفك جلطتني	Negative
يا ترى الحكومه بدها تزيد دعم المواطن الي الله يكون في عونه	Negative
الله يثبته يا رب ويثبتنا نحن كمان	Positive
اخر واحد مهستر	Negative
مثل الاميره من حواليها حرس تمشي دلع و من الترف متعاليه ما كل خيال يروض له فرس مهره اصيله من حلاها غاليه	Positive
تعليم الاطفال على الاغاني وعلى الرقص بدل من تعليم القران الكريم بدل من تعليم الدين الله لا يوفقكم	Negative
وبكل تبلد اعترف لكم باني اقل نساء الارض صبرا	Negative
ليش يعني اخترت انه مصيره في فتح يا تافه وفي المؤتمر السادس كمان يا ابن الكلب	Negative
صلوا علي من بكي شوقا لرؤيتنا	Positive
من اهم مشاكل التعليم الجامعي في الجامعات الرسميه الاردن، مشكله الاعداد حيث ان كل جامعه متجاوزه السقف الاستيعابي لها بالاف الطلاب	Negative
خبار الموت تهز قلوبنا بعمق وسياتي اليوم الذي تهتز فيه قلوب من حولنا لموتنا ، يارب نسالك حسن الختام ورضاك عنا	Positive
الخشوع احساس جميل جد امام الله القلب يحب الدمع صافي متعه بعد الصلاه راحه فائقه اتمنى لكل المسلمين هذا الخشوع	Positive
صباح الدرب للجنه وبلبل شادى بفنه وريحه الياس والحنه اقولها لكل احبابي اللهم اجعلنا ممن يتمتعون بروح وريحان وجنه النعيم من الرحمن	Positive
النقاش العقلاني ينتهي يانك تقنع الشخص يا انك تقتنع اذا ما انتهى النقاش كذا واللي قدامك مصدي الحل الثالث تتفل بوجهه و بكذا يكون انتهى النقاش	Negative
تؤلمني باسم الحب	Negative
دلوعه حيوانه?	Negative
وجعتو راسي	Negative
حلو الشخص يكون عنده هدف يشتغل عليه لكن الدراسه شئ ضروري	Positive
اللهم قني عذاب النار ادخلني جناتك	Positive
قرف يقرفك	Negative
ساترك حبك ليس كرها فيك ولكن لكثره الشركاء فيه	Positive
ماعندك شرف	Negative
بطلت كتير وكل ما اترك والتزم مع ربنا برجع تاني وكل اما ارجع ارجع اكتر من الاول	Positive
اكثر بني ادم يعاني في الحياه هو المغترب بين الاردن والسعوديه لا اللي هنا فاهين عليه ولا اللي هناك والكل ما بحبو	Negative
اللهم لا اعتراض على حكمك ارزقنا انت خير الرازقين	Positive
يا طيبه الخير جينا يا طيبه بالروح افتدينا	Positive
صدقت يا استاذ عمر	Positive
برنامج فاشل جدا	Negative
يا لله ارحم احبتي و شافيهم وعافيهم واعف عنهم	Positive
اضحك وفرفش لكن بحب واداب اعرف حدود المزح واعرف محله	Positive
سخيفه قووه	Negative
هذول مجانين اكيد ما بوافق مش هبله انا	Negative
يا لطيف الله يلطف فينا يصلحنا ظاهر باطن	Positive
دائما تبعث النشاط الحيويه في النفوس مع كل صباح اسعد الله صباحك	Positive
انا الوحيده الي احس طعم الببسي كنه حديد مصدي	Negative
اتفه على هيك برنامج عالمي	Negative
اللهم اهدنا فيمن هديت وعافنا فيمن عافيت	Positive
الله يرحم هلبلاد من الحراميه والمتسلقين على قوت الشعب لك الله ياشعبنا	Positive
فضحتونا من وين نحنا بال 48 عنا برامج هيك تافها ومخمج	Negative
كيف صرت كاتب يا زلمه ؟؟ انت كثير عليك حمار	Negative
جميل جدا	Positive
نشاطر اخوتنا في الاردن احزانهم على الاغتيال الوحشي للطيار معاذ الكساسبه داعين الله ان يكون من الشهداء و ان يسكنه فسيح جناته	Negative
يا الله عالمواساه يرحم ايام زمان	Positive
جمهور لا يياس الى اخر ثانيه	Positive
سلطان القرف	Negative
الحب في الله شيء جميل جدا	Positive
شو هالمنشور الوسخ	Negative
من ترك شيئا لله عوضه الله نورا وايمانا في قلبه	Positive
الله على دينا العظيم	Positive
اللهم ارزقنا الصدق الاخلاص	Positive
يا حبيبي هاي صار للرجال تنانير؟ تفي هيك رجاله	Negative
عيب عليكوا تقارنوا وحده زى دى بالمصحف الى هوا كلام ربنا	Negative
انا فعلا مؤمن بالفكره دي جدا وبحاول انفذها	Positive
عشان هيك قال النبي صلى الله عليه وسلم ان الكذب يهدي الى الفجور والفجور يهدي الى النار	Positive
رب كريم	Positive
والله الناس دي ما شايله هم ابدا علشان كده مسخرو نفسهم او كرامتهم راحت	Negative
دمرني النصاني هودعيك يربي بطني	Negative
لجنه تافهه	Negative
لا تخسر قيمتك بكلمه، ولا تفقد احترامك بزله، ولا تجعل همك في الدنيا هو حب الناس لك،فالناس قلوبهم متقلبه قد تحبك اليوم و تكرهك غدا	Positive
هذا عدا عن عنصريتكم البغيضه وجلافتكم وعنجهيتكم الفارغه مع بقيه الشعوب	Negative
يعني لو عايزين يبعوه بلغوني من القرف هاض يع يع يع	Negative
انا ما اغيب الا اذا كرهت اني ابقى راجع افعالك قبل كل حاجه	Negative
احسنت كلام دقيق جدا	Positive
اللهم اصلح نفوسنا لما يرضيك عنها	Positive
لو اغلقت الابواب في وجهك واظلمت الدنيا خنقتك الدموع و ضاقت بك الارض استحضر معنى اسم الله الفتاح القادر سبحانه قادر على فتح ما انغلق من امرك	Positive
هذا واحد واطي ميمثل غير نفسه	Negative
اللهم ارزقنا فعل الخيرات وترك المنكرات	Positive
اللهم وفقنا لما تحب ترضى يا رب	Positive
امشي عدل يحتار عدوك فيك	Positive
العجوز هذا والرجال الي بجنبه بله واغبياء وانهم يثبطون الواحد	Negative
صباح الحريه والنصر	Positive
لا ياس مع الحياه	Positive
و ما من دابه في الارض لا طائر يطير بجناحيه الا على الله رزقه	Positive
عدوله السامج هذا خرب اوم المقطع قسسم زباله هالادمي ودمه ززفت انا ضحكت	Negative
يارب ناخذ القرار الصح	Positive
اظن انهم حبو وانجرحوا وضاعت عقولهم وما دخل قلوبهم الا اغاني الجروح عشان كذا حافظينها وجايين يقولونها اللهم لاشماته	Negative
عجبتنى الحلقه	Positive
فعلا الطاقه الشمسيه هي البديل ليست النوويه لان حتى الدول المتقدمه صارت تتخلص من النووي تتجه للطاقه البديله خصوصا نحن الاردن بلد مشمس عالطول السنه الكلفه ما اتوقع اكثر من الطاقه النوويه	Negative
فيروسات بشريه	Negative
واي ناس فاظيين صج عاهات	Negative
حاويه زباله بوجهك	Negative
والله هبل في هبل	Negative
طيب الله انفاسك وياسلام لو الشباب او الشابات اذا احبو يحبون كجب شاه جاهان وممتاز محل	Positive
الجمال : ليس فقط شيئا نراه بل هو شيء نكتشفه ، روح جميله ، وفكر جميل ، اخلاق جميله ، وادب جميل	Positive
قرفت انتحر عن الدرج	Negative
و تربت على كتوفنا تشحننا بالتفاؤل ايضا صباحك اسعد	Positive
يمتاز الاردن بتنوع السياحه فيه فتنقسم السياحه الى سياحه علاجيه سياحه دينيه سياحه معارض سياحه اثار	Positive
ربنا يقوي ايمانك	Positive
بارد ومصقع	Negative
حرام السخريه من الناس	Negative
لا شو انا مسخره كلكو خنازير	Negative
ليش ما نتعلم من الي صار في اليابان وروسيا المانيا الغت نظرتها في بناء مفاعلات نوويه استخدام الطاقه البديله	Negative
هذا الشخص هو انت يامصطفى	Positive
لكن هذا البرنامج السخيف الرخيص واضح التمثيل فيه	Negative
ان شاء الله ربنا يعينا على فعل الطاعات	Positive
اهلا وسهلا بشخصك الكريم	Positive
كس امكم يالعرب يابهايم يابقايا حضارات الامم	Negative
قول يا رب وخد قرار	Positive
ربى يزيدن ايمان وتقه يارب	Positive
انا علي ثقه اني استطيع فعل اي شئ لاني انا من صنع الله	Positive
بلد يديرها اغبياء حراميه	Negative
ما شاء الله جميله جدا	Positive
والله مش طبيعي حرام الله غير تنتشر السرقه النهب خرب الامان النشور	Negative
كل شئ ماله معنى بهالحياه الا الفلوس هي الحياه وهي من تقرر مصير كل شئ بهالدنيا الا شئ واحد الموت لا يتناغم مع الفلوس	Positive
ربنا يقويكى على اخد القرار الصح واحسنى الظن بالله وتوكلى عليه وربنا يقويكى على ضعفك يارب ويعدك عن الغلط ده	Positive
اكيد الله لا يحرمنا من هالنعمه العظيمه	Positive
خبل معوق	Negative
فعلا والله هو القرار والثبات عليه	Positive
سبحان الله اللهم ارزقنا الطمانينه اليقين	Positive
اكيد حياتي ما في حدا بشبهك لو في كان نتحرت زمان	Negative
تركنا كل شئ من اجل رضا الله اللهم ارضى عنا	Positive
يا سلام ما احلى ان يواسي المسلم اخاه هذه هي اخلاق الاسلام	Positive
بنص المقطع سقاله موطبيعيه	Negative
اللهم اكثر من امثالك يا دكتور عمروالله نفسنا تشرفنا فى مسجد الصديق بشرتون هليوبوليس	Positive
الله ما يحرمنا من كلماتك الحلوه يا شيخنا	Positive
ترتيب ونظام منقطع النظير في احدى مدارس الاناث بقطاع غزه	Positive
صباح ملؤه الحب العرفان	Positive
زنخه زيك	Negative
شباب صايع مو ملاقي ياكل مخه فاضي متخلف عقليا	Negative
اذا كان حالك احسن من حالو دوس لايك وقول سبحان الله	Negative
هو نحن خلينا نخلص ام هالبرجين اللي صرلهم 16 سنه بعدين بنفكر نعمل نووي سلمي من الديسي	Negative
طريق واحد عدم اليئس هو طريق النجاح	Positive
شفتها اقول وشذا الكيك	Negative
ربنا اصلح احوالنا	Positive
لا مو حقودين ولا شي	Negative
يهدي الله من يشاء	Positive
انا داشره وغير متزوجه ولدي علاقات مشبوه واحشش واحيانا اهرب مخدرات و اجيد التسليك احب ان انكب نفسي وعلاقتي بالمنزل متوتره جد	Negative
عاهات اللهم لاشماته	Negative
و نرجو لك دوام الخير المحبه من الله من الناس	Positive
الله لا يرفعه من مكانه اللي برفع الاسعار	Negative
من المدرب مرورا بالمدافعين والوسط الى المهاجمين كلهم كانوا في اسوء حالاتهم	Negative
وقف قلبو لحسن الشافعي	Negative
المشاركين بينو للناس انه اللى قايمين على البرنامج حمير	Negative
عاهات العرب الجرب	Negative
فعلا زي ما حكى اخر شي مهزله وانا مهزله اللي ضيعت وقتي اشوف هيك مسخره فعلا اني مسخره	Negative
سبحان الله مواقف لها معنى قيمه فعلا تعلم ما شاء الله	Positive
والله نفسى بس الواحد بيجى عليه فترات ينسى يعمل ايه بجد	Positive
الله يلعنك	Negative
مفيش اكرم ولا ارحم من ربنا	Positive
اللهم ابعد عنى شهوات الدنيا وقربنى منك واغفر لى ولكل المومنين	Positive
التطبيقات قليله بالمتجر ولازال امام مايكروسوفت عمل طويل للتغلب على هذه المشكله	Negative
كل شخص فينا بيتمنى الخشوع في صلاته يا رب يتقبل صلاتنا صيامنا	Positive
لا طبعا التقرب الى الله هو خير علاج للحالات النفسيه	Positive
ايه الاحساس الراقى	Positive
ارجوك يا استاذنا الفاضل ادعيلي بالنجاح في مسابقه المجستير العام القادم والشفاء بارك الله فيك	Positive
والله لو طلبوا مين اللي عندو قلب قوي ?? متر للجري مايتقدم ولا حمار عربي	Negative
حلمي اكون ممثله افلام دعاره	Negative
سبحان الله خالق السماوات الارض	Positive
قمه التخلف البشري الله يشفيهم	Negative
كلام طيب	Positive
اما الغبي اللي يقلد جورج وسوف	Negative
صدقتي رائعه معبره الكلام	Positive
تدرون يا جماعه الخير انها بتتعدب والله	Negative
اللهم باركي فيه واهدي كل مسلم لطريق النور	Positive
انا عرف شيء والله ببكي اكتر ما بضحك	Negative
اللهم اجعلنا ممن يعطي الامانه حقه	Positive
احسن اظن بالله وتوكل عليه وحده	Positive
جزاك الله كل خير بسمه امل رائعه وشيقه جد	Positive
اخر واحد اش فيه مجنون المفرووض اللجنه تمنع المجانين	Negative
صادقه وفنانه من الزمن الجميل والفن اخلاق واحساسها يدرس	Positive
ساعد نفسك بنفسك حتى تجد الطريق المناسب الذي تريده، اكتشف قدراتك واستغل مواهبك ولا تترك نفسك لحيث تاخذك الرياح فينتهي العمر قبل ان تحقق حلمك!	Positive
والنعم والاخلاق والنعم والصداقه والنعم الاخوه	Positive
اللهم رزقنا مكارم الاخلاق	Positive
صباح الرحمه و البركات ان شاء الله	Positive
انته جميل جدا ربنا يثبتك واتمني ان كل المسلمين تكون اخلاقياتهم في حياتهم العاديه قدوه ودعوه لكل غير المسلمين	Positive
دعوه اخاك بظهر الغيب لا ترد	Positive
فدمك عود مع عنبر	Positive
لا تحاول لفت انتباه احد , ان لم تكن ملفت بالفطره ستبدو احمقا بالتظاهر	Negative
الله اكرم الاكرمين اللهم اعنا على انفسنا واللهم ارضى عنك يارب العالمين	Positive
كانت الحياه صعبه والمدرسين خشنين واغلبهم من الاردن وفلسطين لكنهم علمونا الادب والعلم غفر الله لامواتهم	Positive
ربنا يصلح احوالنا يا رب ظاهرا باطن	Positive
ان شاء الله وربنا يعيننا	Positive
الجنه تحت اقدام الامهات , اللهم اجعل امهاتنا من نساء الجنه	Positive
صح لسانك	Positive
سلمت سلمت يداك انها الاخلاق الكريمه التي علمنا اياها رسولنا الاعظم صلوات الله سلامه عليه اننا انشاء الله سنفعل ما بوسعنا حتى نرسم صوره راقيه جميله عن ديننا اخلاقنا الله المستعان	Positive
ما ارحمك يا ربى بخلقك سبحانك يا حبيبى يا الله	Positive
بعض الاصدقاء يشبهون المطر في قدرتهم على تعديل المزاج هؤلاء من احتاجهم بقربي	Positive
جزاك الله كل خير دكتور عمرو ربنا يتقبل منا منكم سائر الاعمال	Positive
ملاحظه الكبسه ما بتكهرب والله	Negative
اي تفائل هاد يا زلمه روح تشائم احسلك	Negative
يا سيدي هدول عاهات ولله يعني فيك تسحب عليهم قرض من البنك كونهم عاهات	Negative
احذفه لاني بجلس احش فيهم لمين اكفر	Negative
الاخلاص اللهم انا نسالك الاخلاص فى القول العمل السر العلن	Positive
ماشي هسا انا صرت وله طيب في حدا بيشبهك كتتير	Negative
لو سمحت لا تقول اخبار مغلوطه ولا ابعطيك انفولو جيب رابط الخبر وبلاش تصرف من راسك	Negative
يخرب بيتك ما ازنخك	Negative
صباح النور السرور الورد المنثور	Positive
صوتها بعير ومصدقه حالها	Negative
يجب على كل مسلم الاعتزاز بدينه في جميع الامور صغيرها كبيرها	Positive
الحياه مستمره سواء ضحكت ام بكيت	Negative
كرهت كلمه نازح، لاجئ، ازمه، وضع، توره، تاريخ، جغرافيا	Negative
طلعوا العرب اخس واخس واخس	Negative
ياريت حدا عم يواسي السوريين بغربتهن للاسف باب رزق جديد للعرب	Positive
والله انك ما زليه يا شيخ اكيد مدفوعله من تحت تحت	Negative
برنامج معوق ومشاركين معوقين:	Negative
الحمد لله على نعمه العقل و سعه الفهم و نضوج الفكر	Positive
الله يلعن الي علمكم التطور يا متخلفين يا رجعيين	Negative
انا اشوفه انه عادي ولا فيه اي معنى وايش مليوني مشاهد والله انه ما يستحق الى هذا الحد من المشاهده وبعدين هاض شي مقزز	Negative
هكذا المسلمون	Positive
هو هذا اسلامك يا زاني	Negative
يا سلام على الوفاء اللي اتفقد في عصرنا ويا حسرتاه على الحب الذي بات مجرد كلمات	Positive
يلعن ام الازعاج	Negative
انا لا احلم ان اغير العالم ولكن احلم بان استطيع ان ارسم البسمه علي وجوه الاخرين	Positive
يعني ما اختار الا الاغنيه اللي اغلب احرفها الحرف اللي يقرط فيه	Negative
فعلا البت جده لما تحتاج ليه هو الانسان الصادق هو البستاهل تضحي عشان	Positive
اموت فيج رويده	Negative
الحب الحقيقي عمله نادره فعلا وهو نعمه كبيره من الله عزوجل	Positive
لانهم يمكن يكونو قاهرينك	Negative
لا استطيع اللهم ارزقنا العافيه وشكر نعمتك	Positive
احتمال ما يشارك الليو البايخ	Negative
فعلا الله يجزيك كل الخير دكتور والله يثبتنا على ديننا	Positive
يسعد صباحك بذكر الرحمن	Positive
انما المؤمنون اخوه فاصلحو ذات البين	Positive
تسلم انت وافكارك	Positive
نسال الله العفو العافيه	Positive
على الاقل هناك رجل وفي لامراه احبها وهذا يسعدني	Positive
هاي اخلاق خليلنا الحبيب	Positive
صح علشان كده منكذبش ونرتاح	Positive
يا رب اجعلنا من الصالحين	Positive
الله يخلف علينا بس ، يقال لا فقر اكثر من الجهل ولا غنى افضل من العقل !!	Negative
ربنا يهديني ويجعلني من الخاشعين والمسلمين اجمعين	Positive
نسال الله تعالى ان تكون بحق ارحنا بها يا بلال ليس ارحنا منه	Positive
الف الف مبروك يستاهل والله يوفقكم	Positive
احلى اشي في الحياه الاستقرار مع زوج صالح	Positive
والله رفعتوا راسنا يا شباب الله يقويكم	Positive
الماء اساس الحياه	Positive
يارب كرهنى وابعدنى فيما يغضبك	Positive
مش من بني ادم انتي من جنس الحيوانات	Negative
الفلاكا تجعل من يتناولها يعتقد انه زومبي واكل لحوم البشر ويبدا بالبحث عن دم ليشربه وظهرت في التسعينات في امريكيا ثم اختفت	Negative
اخرس صحيح ما تفهم	Negative
خليه يرفع لكن اللي عنده وطنيه انتماء يصف سيارته بالشارع يروح على الشغل مشي	Negative
غبي الله يزيد غباك	Negative
معك حق	Positive
اﻻسلام ليس فيه رهبانيه انما هو دين علم وعمل وبحث URL وعندما طبقنا هذا المبدا سدنا العالم	Positive
هذول مساجين ولا ايش	Negative
يخرب الدلع	Negative
جسمها حلو ترقص عاريه	Negative
ولك واحد كندره	Negative
بيجيبو الشيوخ ليسهز فيهم	Negative
هي فلسطين راحت من قليل يا ولاد المخنثه لعنه الله عليكم فظحتونا	Negative
لا مش فاهماك	Negative
كلام حقيقي	Positive
من الي ضاحك عليهم انو اصواتهم حلوه	Negative
هاد برنامج وسوبر ستار بنامج شوف البريطان شو بعملو فعلن سوبر الهبل	Negative
ما اثقل دمك ما اغباك	Negative
وش فيك معصب خلاص بعطيك اللايك الي جاني خخ	Negative
ربنايقويك اتشجعي وخوذي قرار وخلي الصحبه الصلحه جنبيك	Positive
الحريه غاليه لن تجدها عند متسول اخواني ساذج لايملك منطق ولافكر	Negative
صبحكم الله ياهل الطيب بالخير يسعد ضحاكم الظهر العشيه	Positive
كنا نقول البلد حاميها حراميها ماذا سنقول الان مفتيها حراميها الله الواحد تحير في هذه الامه التي اصبح الحليم فيها حيران	Negative
زمان المطربيين اللى غنو لهم المعاتيه دول ولعو فى مقابرهم وبيعيطو بدل الدموع دم على تراثهم اللى راح	Negative
هذا هو المهم	Positive
شكرا دكتور فكلماتك لها بالغ الاثر في نفوسنا	Positive
صباح الخير لك ياشيخ لكم كلماتك دائما تشعرني بالامان والسكينه والرضي بما كتب الله	Positive
الثقه بالله ثم النفس ويارب اجعلنا من يغير الناس الي ما ترضيه	Positive
ولا جورج في الزمنات بس حرام يفضحوهم	Negative
انا شوفت وقاحه بس زاي وقاحه الاخوان ما شوفت	Negative
كثر الله من امثالك زادك الله علم	Positive
لدى الاردن مؤهلات عظيمه لاستغلال الطاقه الشمسيه وطاقه الرياح وطاقه باطن الارض والوقود الحيوي. وكلها طاقه امنه ونظيفه ومتجدده.	Positive
هاي نتيجه انه ينحط انسان في موقع مسؤوليه	Negative
اقترح تحويلهم الى طبيب نفسي ليس الى القضاء	Negative
مين اللي ضاحك عليهم وقايل ان اصواتهم حلوه	Negative
مؤامره معروفه ضد الشرفاء في هذا البلد	Negative
بالله تسكتوا خلينا بحالنا بدناش مشاكل ايه	Negative
والله حرام يعني ما يدرون انهم مصخره	Negative
كسم العته البشرى	Negative
اساس الاصلاح واهم مرتكزاته المعلم داخل غرفه الصف مع طلابه وتلاميذه والاعتماد عليه بالتنفيذ لخطط واستراتيجيات عليا	Positive
التنفس العميق يوفر علاج طبيعي للصداع	Positive
اللهم ثبتنا على قيام الليل في رمضان	Positive
يارب دعوناك فستجب لنا وحقق لنا ماهو اصلح وافضل لنا	Positive
الشعب الذي اختار نواب خرجين سجون سوابق بستاهل اكثر من هيك مشان 50 دينار الله لا يرد هيك شعب	Negative
يا رب رضينا امنا صدقنا فارضينا برضاك عنا اجبر كسر قلوبنا هون علينا	Positive
كارثه بشريه	Negative
وربي كلبتي جات جلست عندي اول ما فتحت هالفيديو ويوم خلص التفت لها الا والاقيها نايمه	Negative
اتحزن فان الله يدافع عنك والملائكه تستغفر لك و المؤمنون يشركونك في دعائهم كل صلاه و النبي صلى الله عليه سلم يشفع و القران يعدك وعدا حسنا و فوق هذا رحمه ارحم الراحمين	Positive
عرب جرب	Negative
والمصحف عاهات	Negative
فتاه تحاول استعراض جسدها	Negative
المواساه والمحبه بكل الامور رمز الاخوه	Positive
الله حيهم هالشباب انتوا القدوه	Positive
ما شاء الله .. ونعم التعليم في الاردن URL ابدعوا الشباب !!	Positive
شو هل الاهبل	Negative
واسال الله من اثواب رحمته سترا جميلا على الزلات مشتملا وان ييسر لي سعيا اكون به مستبشرا جذلا لا باسرا وجلا *	Positive
شكرا للنجمه الراقيه كنزه اخبار النجوم	Positive
يا رب اسعد قلبي و قرب لي الخير	Positive
بعرف بس مو حلو	Negative
اللهم ارزقني كما ترزق البغاث	Positive
هنا نجد اصحاب السوء يحضرون بقوه لان ها هولاء لم يحظروالى بعد تشجيع من اناس حولهم	Negative
الله لا يخلف عليهم لا يكثر خيرهم فعلن شعب مسكين عبد الله النسور بطل رفع الاسعار	Negative
ما بتحبو حد	Negative
مهزله التاريخ	Negative
التفائل حلو في الحياه بس الاهم تكون عايش مع ناس متفائلين مش تكون لحالك المتفائل	Positive
اما وهابيتك فحدث ولا حرج الناس يقادون الى المساجد غصبا ويجلدون كالابقار ان هم ابوا	Negative
بيه الزناخه	Negative
يعني كل جامعات الاردن عندهم نظام، و احنا عنا خرا	Negative
يا رب ارزقنا الفرح والسعاده	Positive
انه دين يسر وليس بدين عسر	Positive
صباح الهمه النشاط شيخنا الفاضل	Positive
ان شاء الله هنكمل مشوار النجاح	Positive
وجهك مش الك	Negative
كلب وحقير	Negative
البنزين يجي من السعوديه باقل الاسعار الحكومه عندنا تدبل سعره	Negative
يارب اجمع امتك علي دينك يارب وشت اعداء الدين	Positive
اللهم ثبتنا بالقول الثابت في الحياه الدنيا وفي الاخره	Positive
صبح يحكي للتلفزيون الاردني العقار في الاردن رخيص ! وجميل .. رخيص يعني بنقدر نملك شقه ب 100	Negative
يا الله ما احلاه من خبر والله فرحتوني	Positive
تسلم صرمايتك	Negative
مرره دلوع	Negative
الى اعتصام مفتوح ميدان تحرير للتخلص من قوى الفساد الافساد	Negative
ماكرمك يا ربي يا كريم	Positive
الحمدلله على السلامه وماتشوف شر .. طهور وقدامك العافيه ان شاء الله	Positive
كل سنه وانتم طيبين	Positive
لا والله ما بلسه يع	Negative
بس الحكام ماعندهم ذوق للاسف	Negative
البرنامج فاشل جدا	Negative
خير صديق في الزمان كتاب	Positive
هلا كففت عن قسوتك	Negative
صور جميله	Positive
الدين عباره عن اخلاق وحسن التعامل مع الناس وتهذيب النفس قبل ما يكون مجموعه من العبادات !	Positive
شكلو عمرو ماشاف كاميرا تصورو	Negative
الله يجعل ابوك وامك من اهل النار اذا بتعيد هالحركه مره ثانيه	Negative
الله يشافيك يعافيك من كل داء وهامه اخي سيد الوكيل	Positive
وش هالتحف والله مساكين ماكلين مقلب بقوه	Negative
اللهم تب علينا انك التواب الرحيم	Positive
اكيد ماحدا بيقدر يارب اعن الفقراء واعنا مساعدتهم	Positive
لا تياسوا من روح الله، الله تعالى لا يعجزه شيء، فكم من مريض شفاه، وكم من فقير اغناه، وكم من مشرف على الهلاك نجاه، وكم من ضال هداه	Positive
الروح و المال تفداك يا قلبي	Positive
نحن ما بدنا اياه لانا ما منفهم المفاعل النووي فوق طاقتنا صعب علينا بكره بذكركم سالوا الباص السريع الثقه معدومه القمح فاسد المصفاه مش حسب المواصفات الخضار الفواكه مواد كيماويه شوارع مش مصانه حفر مطبات الخ الافضل استغلال الطاقه الشمسيه او الريح او الماء ليس هروب من التطور انما الابتعاد عن الفشل الاكيد عبر التجارب	Negative
سبحان الله له فى خلقه شؤون	Positive
الله الكلام الجميل	Positive
مهزله ياعيب الشووم	Negative
يا ربي هذا مستحيل يكون كائن بشري	Negative
يا خساره عليكو يا شباب المستقبل	Negative
كل يوم يصدمنا الاعلام بنتائج رقميه مجهوله المصدر والتوثيق والاستقراء حول التعليم في الاردن لتبرروا تغير المناهج المخزي لا لن تخدعونا	Negative
من رافق وافق	Positive
اللهم انصر الاسلام واعز المسلمين	Positive
والله انو نذل	Negative
سلمت يداك روعه	Positive
العرق كل شوي يزيد	Negative
تابعت هذا الجوال من بدايه صدوره وقبل اقترابه للعالم العربي فعلا يستحق كل هذه الاهميه	Negative
الحلو انكم بتحكوا على اساس انو الاردن ما فيه فساد سرقات	Negative
اكبر مشروع طاقه شمسيه URL الاردن اسمه شمس URL الله الاردن	Positive
حتى بالستايل مقلده الله ياخذ عمره الغبي	Negative
يا غبي كوادر الاخوان المسلمين في كل بقعه من هالارض	Negative
صباحكم ضحكه قلب يملاه الرضى اضحك ياحبيب الملايين	Positive
والله انا خايف انو طخوا بعد هاي الصوره	Negative
ممكن يكون احسن بالاخلاص	Positive
ممرضه هايجه تمارس الجنس مع المريض	Negative
هل كلها صالحه للاستعمال ولا من اول استخدام تنفجر	Negative
ليتنا نستطيع الابتسامه في الاوقات المؤلمه	Positive
وجعلنا من الماء كل شيء حي	Positive
المسلسلات خربت بيوت العالم	Negative
هذه البرامج اللي تخلف العاهات للفن الهابط فن اليومين هذا	Negative
كدا عيب اودني راحت فيها	Negative
لقد اسمعت لو ناديت حيا.. ولكن لا حياه لمن تنادي ولو نارا نفخت بها اضاءت .ولكن انت تنفخ في الرماد	Negative
وين القناه التافه الى تعرض هذول المعاتيه صحيح نحن في انحطاط	Negative
معظم اصحاب محطات الوقود وكالات الغاز متنفذين لقد زاد الغني غنى الفقير فقر	Negative
تغني وهي متقرفه	Negative
ولا تنسو تبسمك في وجه اخيك صدقه	Positive
لك كلك ذوق حكمه	Positive
والله مش عارفه شو بدنا نسوي نشحد مثلا	Negative
اللهم اجعلنا دائما مسلمين صادقين في افكارنا في اعمالنا	Positive
تبون تقنعونا انكم تخافون على صحه المدخن وعلشان كذا رفعتوا URL ولو ب100 دينار وبيدخنون ولو بعظم وورق شجر	Negative
من يستمتع برؤيه الناس في مواقف محرجه فهو سادي غير اصيل نفسه ضعيفه مريضه	Negative
نعم الوقت يمر بسرعه	Positive
حركه ارحمينا الله يشيلك اقول كيف اخوكي وابوكي راضيين عنك اف عندك ايزي	Negative
مش عاجبو الوضع الي هو فيه	Negative
لو كان للحب رائحه .. لكانت رائحه القهوه في يوم ممطر	Positive
صراحه الاراده القناعه هيا الغنى الاكتفاء	Positive
بعين الله يا امال كلهن ستين سبعين سنه وبمضن وبتهون	Negative
بلا هم بلا وجع راس خليك رايق دايما	Positive
ما اجمل ديننا الاسلامي	Positive
معلومه ممتازه	Positive
ملعوب عليهم	Negative
لجنه زباله من اذا بفهمو بالفن خاصه ابو النظارات اللي مش موجود بالفيديو	Negative
يارب يقدرنا على ادخال المياه النظيفه لكل بيت محتاجه المياه	Positive
لعنكم الله جهنم وبئس المصير ايها العازفون	Negative
هادي الاخوه الصادقه	Positive
مخالفات السير اصبحت تشكل عبئ اقتصادي على المواطن	Negative
هع مش حلو	Negative
مايستحون	Negative
ياخساره العروبه فيك	Negative
يا ربي شو هالولد الله مجنون مبيستحييش متاكدين انو مغربي	Negative
ومن احسن قولاممن دعالي وعمل صالحاووقال انني من المسلمين	Positive
ربنا يكفينا هذا الشر	Positive
تبا لكم	Negative
عذبت ام العود	Negative
ولا شكل ولا صوت منين جايبينهم هالكائنات الغريبه اه يا بطني بس	Negative
اهل العقول براحه ام نسيانك يابو نسيان صعب والله صعب	Negative
جامعه العلوم والتكنولوجيا الاردنيه افضل من URL من جامعات العالم و URL من جامعات الوطن العربي طبقا لتصنيف ويب	Positive
ايها الصغار المتناكفون انكم مع كل منشور ضد بعضكم البعض تصغرون اكثر مما انتم صغار فلا يسلك هذا الطريق الا صغير ساذج يحب ان يعيش على القذارات	Negative
قصه فى منتهى الروعه	Positive
للهم اعنا على ادراك هذا المعنى العظيم يا رب	Positive
كن ايجابيا وتذكر ان قليلا من التفاؤل قد يصنع الف طريق نحو السعاده صباحكم مليان طاقه ايجابيه	Positive
انا مش مسؤول عن الحراميه يتفنجرو بمصاري البلد انا اشحد	Negative
فاهجر تجد عوضا عما تفارقه	Positive
انتي عنجد بنت فاشله	Negative
لا احنا نتبع نظام مختلط بين الراسماليه والاشتراكيه	Positive
خلق الايثار	Positive
ونشوف اغلى الاحبه في الروضه الرحيبه	Positive
من كانت له عزيمه لن يياس ومن بغي الاجر من الله ثابر حياكم الله اخي مؤمن	Positive
ان الله لا يضيع اجر المحسنين	Positive
اعلن الانسحاب يا حمار	Negative
على فكره المعلقين هدول ولاد حرام	Negative
اهما ودهم يروحون النار لكن النار مارضت فيهم	Negative
للبرنامج التافه الي يسمح لهذا الشي	Negative
خراي على احسن علوي ومحب لهاجحش خربت سوريه ياكلب	Negative
سوريا تعرضت لمؤامره والامر المحزن ان ولاد سوريا انزلقو فالمؤامره هاذي والشنيعه	Negative
والله ظلموه لجنه الطراطير	Negative
نفسي اروح عمره واشوف الكعبه	Positive
شو هاد البرنامج معقول عرضوه على القنوات	Negative
والله انك فشلت العرب	Negative
عيب عليك ماتستحي	Negative
السهر احد مسببات مرض السكر	Negative
اللهم اني اعود بك من الذنوب التي تزيل نعمتك وتحول عافيتك وتحبس رزقك وتعجل بغضبك	Positive
ربنا يكرمك يا دكتور	Positive
شردو اطفلها وقتلوا رجالها	Negative
اللهم اهدنا لكل عمل يقربنا اللى حبك	Positive
رائعين يا مصريين	Positive
ولاه امرك الوهابيين يكرعون الخمر والسديقي كرعا بالسر والعلن دون تطبيق الحدود عليهم	Negative
لان ما بعتقد انو في هالقد عاهات ما بيعرفوا انو صوتهم نشاز لانو كتيير نشاز وازا في رح تكون حالات استثنائيه مو بهاد الكم الكبير	Negative
عنجد الكذب اكبر ورطه	Positive
تاثير الغرب مبين على العرب المجانين	Negative
يا رب ان امسيت بحزن فاصبحني بفرح، و ان نمت على ضيق فايقظني على فرج و ان كنت بحاجه فلا تكلني الا لسواك	Positive
بسعد ربك وصباحك عسل انت وكل من قال انا اردني وبحب القياده الهاشميه وتراب الاردن وسنح الاخوان ولاد كلب على هالصبح	Negative
صح كلامك احلى حكمه محد يبقى للنهايه رغم اتفاق الطرفين	Positive
والغناء تجد لك ?? مليون وكلهم زباله	Negative
حكي فاضي	Negative
جزاك الله خيرا ياستاذ مصطفى على ماتبثه في انفسنا ربنا يكثر من امثالك	Positive
اغرورقت عيناي بالدموع	Negative
ربي يكون بالعون ياخي فقد احزنني كلامك	Negative
والله شويه عبط الي بيغنو والحكام كمان	Negative
اللهم حسننا حسن اعمالنا ظاهرا باطنا لا تجعلنا نعمل الا ما يرضيك عنا برحمتك يا ارحم الراحمين	Positive
انا بدات اتحرك شاركت بفكره ستغير الكثير من واقعن	Positive
فعلا الله يبعدنا عن الكذب	Positive
فاقد لكل معاني الاحساس	Negative
صباح الوجه الصبوح	Positive
ربنا يثبته	Positive
الراجل الابس ثوب عليه جاكيت شكله مسطول من جنوب السودان	Negative
الاسف مافي اي حدا بتحمل الانتقاد	Negative
فاشل فاشله برنامج فاشل	Negative
اذا استعنت بالله وتوكلت عليه ونيتك كانت صادقه سوف يقف الله بجوارك ولن يخزلك ابدا ?احبك ربى	Positive
عظيم هو اسلامنا	Positive
الفن اصبح هابط هذه الايام	Negative
هذا لا يعني خلوها من الاشكال المصديه	Negative
اللهم انا نعوذ بك من الرياء النفاق	Positive
الله يزيدك من العلم ما تنتفع به الامه	Positive
اللهم لا تجعل لحب الدنيا سلطانا على قلبي بل اجعل حبك في قلبي سلطانا	Positive
اللهم اني استغفرك من كل الذنوب والمعاصي واتوب اليك	Positive
بتقول كلام زي الفل	Positive
هذه رويدا عطيه يا الخبوول	Negative
كلام سليم	Positive
فوق من اللي انت فيه ربك دايما جمبك لو ناديتو هتلاقيه جايز ده اختبار ركز فالاجابه وقول يارب وخد قرار	Positive
هاد كلو كزب ياهبله والله	Negative
تبتنا ياربن علي دكرك وشكرك حسن الخشوع في صلاتك	Positive
كل يوم اجتماعات ومناقشات وتحليلات ومفاوضات بشان سوريه وكلو حكي فاضي وعلاك مصدي اذا ما في نيه صادقه مخلصه من كل الاطراف لن تنتهي ماساتنا	Negative
مجانين العرب	Negative
انا لو مكان راغب اروح انتحرر	Negative
استهبال باستهبال	Negative
اجل الاخير واضح انو بيمثل وتمثيلو خام هو والا معو	Negative
كم هي ثقيله على لسانك .. فرائحه الدجل والنفاق بنظرات عيونك !!	Negative
فشرت عينك	Negative
انا ابو عدوله هذا لو قدامي صدق اني راح العن ابو من جابه	Negative
اللهم انا نعوذ بك من غضبك نساللك رضاك	Positive
الحمدلله على كل حال، الفرصه قائمه، والقادم اجمل	Positive
ده عمله نادره الاخلاق ملهاش علاقه بالدين	Positive
العاهات اللي عندهم ياناس روحو موتو اشرف	Negative
ربنا يقوينا ويقدرنا	Positive
فعلا ده صحىح مثلا زى سماع الاغانى التى تلهى عن زكر الله لو تركتها لله ىملا الله قلبك بحبه ولاتشغل بالك الا بذكره	Positive
شكرا لجميل اثراءك المعرفي، كلامك وسلاستك في ايصال المعلومه جميله للغايه	Positive
اللهم ارزقنا العمل الصالح الذريه الصالحه ارزقنا يا الله حسن الخاتمه	Positive
حفظ الله ابناء وبنات الامه جميع	Positive
الله يعطيك الصحه العافيه	Positive
عطله 15 يوم وكمان اسبوع عطله و 20 دينار لكل طالب هاي مدرسه ولا شهر عسل	Negative
لهل درجه في متخلفين في الوطن العربي؟؟	Negative
نفسي افهم من وين جاي يا ابن الكلب	Negative
النظافه من الايمان	Positive
يلعنك نذل وكلب	Negative
روح اكتب اشي زي العالم الناس بدل ما انت بتتهبل هيك بتتمسخر يا مسخره	Negative
الله وكيلك مشحطط اهل دابوق دير غبار عبدون منعم على الفقراء	Negative
طول عمرك تخاف من الحب	Negative
الرائع سيظل رائعا حتى نهايه العمر	Positive
الحق عالحقير اللي نزل المنشور بجوز اهله لابسين منهم ولك لاتنزل اشي زي هيك يا	Negative
والله انك مسخره يا عجوز	Negative
حلو صديق عمري	Positive
اللهم ثبت قلوبنا على الايمان	Positive
حثاله على حثاله والحثاله انظف منهم	Negative
هالانسان مجنون لابس بدله رياضه وجاي يغني حتى لو صوتك زين اللبس عدل	Negative
كانت تسوي مقلب انها محترمه بعدين اعترفت انها	Negative
اوغاد باعو البلد	Negative
من اسرار النجاح المتواصل والثبات على القمه: العمل الدؤوب والانضباط بالمواعيد والاعمال والتفكير الايجابي	Positive
عليا النعمه ابدا لا هو ولا الخروف التاني	Negative
عمرتنا كانت مميزه جدا ورائعه	Positive
من اجل هذا تم قدوم ?? الف من الجيش الامريكي	Negative
والله ايلى اختشه ماتوا	Negative
قصه جميله مهمه جدا	Positive
السلام عليكم الحقيقه انا لا اعرف شو وقاحه هاي اللجنه المشترك يعطي ما عنده من مواهب هذا ما عنده وهم يعطون ما عندهمما	Negative
اخر همي اني اتناقش مع اي كائن حي اواتجادل بذات اذاكان عقيم فكريا	Negative
ربنا لا تزغ قلوبنا بعد ان هديتنا	Positive
انا دمرت انا دمرت مستقبلي ضاع وما معي اكل خبز شو هالحياه شو هالقرف مش حياه الحياه كلها ظلم ما في شغل الاردن	Negative
نار جهنم تاخدو	Negative
نعم الله علي اكثر من ان احصيها الهدايه ، الصحه، سلامهالقلب، ذكاء العقل، صفاء المشاعر ، سلامهالحواس، حفظ الاحباب اللهم لك الحمد	Positive
يرزق من يشاء بغير حساب	Positive
مشاهد وسخه	Negative
اطفال اليوم رجال الغد ومستقبل الامه	Positive
متى يجي عام 2050 عشان ادخل رجلي مع الشاشه واحطها بفمك	Negative
شو هيدا دلع اخر زمن	Negative
اوسخ شي المناديل	Negative
محششين خخ	Negative
ربنا يبارك فيه يكون قدوه للجميع المسلمين فى انحاء العالم	Positive
الله اكبر ما احلاكم وما اشجعكم	Positive
اجتماع حواء اكيد في خرفنه	Negative
اللهم اجعل سريرتي خير من على نيتي اجعل على نيتي صالحه	Positive
برامج سخيفه تهدف لهدم الامه	Negative
اللهم اني اسالك اخلاص النيه كرم الطويه	Positive
ليش معصب يا عدوله	Negative
الحل الوحيد هو القرب من الله وذكره الا بذكر الله تطمئن القلوب قال الله تعالى	Positive
سبحانه يهدي من يشاء لا اله الا الله محمد رسول الله	Positive
احسن شيء العمل الذي يؤدي للاستمراريه	Positive
تبارك الرحمن اللهم زد فينا وبارك لنا يارحم الرحمين	Positive
هذا انا واغني وانا بالحمام وانتوا بكرامه صوتي احلا من العاهات هذيل	Negative
كلام بليغ اللهم ارزقنا الزوج الصالح من يعرف معني رفقا بالقوارير	Positive
هع بدها بس تعلق التعليقات الزنخه	Negative
سبحان الله ان الله يرزق الدوده في جوف البحر	Positive
للهم املا قلبي بحبك وحب نبيك وحب كل عمل يقربني الي حبك	Positive
والله حرام تكاليف زواج ومهر واخرتها طلاق بسبب شي تافهه	Negative
اهم شي الواسطه والمظهر الخارجي	Negative
يارب يتقبل منا والله العقل مو فاضي والقلب مكسور	Positive
جزمتي الا اقولك اسفل جزمتي الثوره في سوريا ما اشعلها الا الوهابيين اللي هم السلفيين	Negative
صح الابتسامه تصنع السعاده	Positive
الحمدلله وربنا يجعلنا من المداومين عليها والخاشعين	Positive
صرفات تجعلك زوجه نكديه بجداره	Negative
حتى فى التخلف مش فالحين منيح	Negative
هاكدا هو دين المحبه الصحيح بس للاسف الكثيرين يتبنوه حسب ما يشتهون	Positive
يا رب يكرمنا باولادنا انا دائما بشجع ابني ان يكون كالجبل الذي لا تهزه الرياح العاتيه	Positive
انا ضد النووي كالاردن البحث عن مصادر للطاقه النظيفه خصوصا اننا نفتقر للماء و الاجدى بنا ايضا ان نبحث عن سبل لحل مشكله المياه بالمبالغ التي ستصرف على المفاعلات النوويه	Negative
فقد عجزت الكلمات	Negative
املا رئتيك بعبق السماء مع ولاده صباح جديد تهتز له الحياه تحتفل ايقظ عقلك بالنور ابعث همتك حيه متوثبه لتطوي نهارك في فرح	Positive
والله اول واحد سمعته منهم احسب سماعتي خربا يا بطني من الضحك والله زاحفين	Negative
سلوا الله الجنه والحوا عليه في طلبها ييسر لكم اسباب دخولها فكل نعيم دونها شقاء وكل فوز دونها خسار فمن زحزح عن النار وادخل الجنه فقد فاز	Positive
خلتنى اضحك رغم انى مكتئبه جدا	Positive
الله حيك شيخ ابراهيم بالفعل حكم يا نشمي	Negative
احسنت وصفت ما يدور او يجول في راس كل شاب ملتزم كل فتاه عفيفه نقيه تقيه	Positive
ما في داعي لمصايب جديده للبشر وللبيئه	Negative
الوحيد الذي لايتركني ولو لحظه	Negative
كن كما انت لا تتغير من اجل احد	Positive
الله يثبت قلبك على ديننا الاسلام	Positive
صبحك الله بالخير	Positive
لا كرامه في الحب والغرام	Positive
اللهم انك عفو تحب العفو فاعف عنا	Positive
ربي ينعم علينا بنعمه الخشوع	Positive
منيك ولك	Negative
هذا معوق جنه جورج وسوف	Negative
اللهم ارزقنا واياك الجنه	Positive
ربك دايما جنبك لو ناديتوا ها تلاقه	Positive
ما شاء الله والله انها امر متل الكرتون	Negative
يا الله استجب دعائي يالله مادكيت بابك يوم ورحعتني خاليه الوفاض	Positive
الاردن لا تمتلك اي الخبرات الفنيه في انشاء او صيانه او تشغيل المفاعلات النوويه لاردن ليس لديها سوى شهادات دكتوراه في هذا المجال نظريه بحته ان انشاء مفاعل نووي يعنى مقامره كامله بمئات الملايين المضحك في الموضوع ان بدايه المشروع ستكون انشاء مفاعل تجريبي او تعليمي يتبع لهيئه الطاقه النوويه اليس الاجدر بهكذا مفاعل ان يتبع لاحدى الجامعات علاوه على ان كل هيئه الطاقه تم انشاها رضوه لفلان وعلنتان الاولي يا ساده ان يتم طرح انشاء شركه للتنقيب عن اليورانيوم وبيعه لتصبح الاردن دوله مصدره لهذه الماده امر اخر كثر الحديث مؤخرا عن انه يوجد في الاردن بترول بكميات على الاقل تكفي استهلكنا المحلي	Negative
يا الله كلامك بلسم	Positive
شعب سخيف	Negative
كافر ملعون جهنم باذن الله	Negative
معتيه واضح انهم يمثلون	Negative
اضحك امام كل الناس لتسرهم تجبر خواطرهم فتبسمك في وجوههم صدقه	Positive
نعم مصر عايزه راجل مش واحد وسخ بيقرف	Negative
اللهم اذقنا حبا رائعا حلالا طاهر	Positive
لازم يحكم عليهم بالسجن	Negative
الي استحو ماتو	Negative
اكيد لا في عندك ناس بتفهم ووفي ناس عند الاجانب ما بتفهم	Negative
وش التخلف هذا	Negative
غباء في غباء لان نفس الحركه صارت في يعني قلدنه البرنامج وبعد التصرفات اووف	Negative
يا مقلب القلوب والابصار ثبت قلبى على دينك	Positive
قرف شوهاد شي بخزي عنجد	Negative
كانهم خرفان العيد عند المسلخ	Negative
ليش تتضحكو مش حلو	Negative
سوبر حمار والله هذا السوبر حما سبب في تخلفنا	Negative
نحن بنتهاوش مع الكتب	Negative
كان نفسي اكون شخص بارد ، يتقبل اي حاجه من غير ما يتاثر.	Negative
