content	label
 اللهم  ارزقنا  فعل  الخيرات  وترك  المنكرات	Positive
 كلام  سليم  والصراحه  راحه	Positive
 حتي  في  التخلف  مش  فالحين  منيح	Negative
 شو  هل  الاهبل	Negative
 اشتقت  لمكه  و  لراءحه مكه  و  لالصلاه  في  مكه  اللهم  ارزقني  انا  و  كل  من  اشتاق  الي  مكه  بزياره عاجلا  غير  اجل	Positive
 هما  بس  الي  بيسعوا  لالغناء  ده  طبعا  غير  الاشتغالات  والافلام  الهندي  الي  نحن  شفنها	Negative
 ابو  الشباب  راعي  العود  ليش  ماوزنه  في  البيت  غباء	Negative
 صباح  الوجه  الصبوح	Positive
 مين  اللي  ضاحك  عليهم وقايل  ان  اصواتهم حلواه	Negative
 لجنه فاشله تتمسخر  علي  المتقدمين	Negative
 الدال  علي  الخير  كفاعله	Positive
 معايا  زميل  زميل  يلعن  المسخره  كلهم مايستحون  ذولي	Negative
 البنزين  يجي  من  السعوديه  باقل  الاسعار  الحكومه  عندنا تدبل  سعره	Negative
 باذن  الله  بديت  ولو  مءخرا  بنفسي  الحمد  لالله	Positive
 البيت  اللي  فيه فرح  سعاده  دايما  بكون  متفاءل  سعيد  بحاضره مستقبله	Positive
 اللهم  احفظني بحفظك حسبي الله  لا  قوه  الا  بك	Positive
 اللهم  اغفر  له وسع  لك رحمهك له اصلح  له ذريهه	Positive
 الدول  المتقدمه  الان  تتجه  لستخدام  الطاقه  المتجدده  انها اقل  كلفه وليس  لها مخاطر  علي  البيءه  والانسان  ونحن  الان  نعاني  من  ضاءقه  ماليه  كبيره وشحه مياه  شديده وكلنا يعلم  مدي  حاجه المفاعل  لالمياه  اذكركم فقط  بما  حدث  في  اليابان  وهي  الدوله  الاكثر  تطور  في  مجال  التكنولوجيا  وهي  عباره  عن  جزر  وكذلك  كم  اثر  علينا المفاعل  النووي  الاسراءيلي  وحالات  السرطان  المنتشره  ولو  لاحظنا  التشوهات  الخلقيه  الاكثر  في  جنوب  البلاد	Negative
 ربنا  يعيننا علي  نفسنا	Positive
 يا  هيك  الاكل  يا  بلا  لش  الحكي	Positive
 ربنا  يصلح  احوالنا يا  رب  ظاهرا  باطن	Positive
 بعد  عن  التشاءم  وعيش  يومك بالتفاءل  لغد  احلي	Positive
 اللهم  يا  محول  الاحوال  حول  حالي  ان  احسن  حال	Positive
 زنخه زيك	Negative
 اللهم  اجعلنا  من  اللذين  يصلحون  في  الارض  ولا  يفسدون	Positive
 من  اجل  هذا  تم  قدوم  ?  ?  الف  من  الجيش  الامريكي	Negative
 التطبيقات  قليله بالمتجر  ولازال  امام  مايكروسوفت  عمل  طويل  لالتغلب  علي  هذه  المشكله	Negative
 ناس  عزيزه المعزه  لهم غير  فيهم صفات  الصالحين  العليه	Positive
 لجنه زباله من  اذا  بفهمو  بالفن  خاصه ابو  النظارات  اللي  مش  موجود  بالفيديو	Negative
 يا  رب  يكرمنا باولادنا انا  داءما  بشجع  ابني ان  يكون  كالجبل  الذي  لا  تهزه الرياح  العاتيه	Positive
 وش  يحسون  فيه ناس  مهبل	Negative
 يلعن  ابو  الي  ما  بستحي	Negative
 انا  الوحيده  الي  احس  طعم  الببسي  كنه حديد  مصدي	Negative
 شغل  مشغول  قرف  يع	Negative
 كلمه حب  عجبتني جيت  اقءلها  جرحتني	Negative
 الحب  في  الله  شيء  جميل  جدا	Positive
 شعوب  تافهه همها الحياه  الدنيا  فكروا  في  نهايهكم	Negative
 الحلال  بين  و  الحرام  بين  واتقوا  الله	Positive
 بيجيبو  الشيوخ  ليسهز  فيهم	Negative
 تبون  تقنعوانا انكم تخافون  علي  صحه  المدخن  وعلشان  كذا  رفعتوا  السعر  .  .  بيشترونه  ولو  ب  100  دينار  وبيدخنون  ولو  بعظم  وورق  شجر	Negative
 صباح  الخير  لك ياشيخ  لكم كلماتك داءما  تشعرني بالامان  والسكينه  والرضي  بما  كتب  الله	Positive
 زاكي  اكيد  رهف  بكفي  انه من  مشتقات  الحليب	Positive
 فشرت  عينك	Negative
 لدي  الاردن  مءهلات  عظيمه لاستغلال  الطاقه  الشمسيه  وطاقه الرياح  وطاقه باطن  الارض  والوقود  الحيوي  .  وكلها طاقه امنه ونظيفه ومتجدده .	Positive
 انشالله  انو  يطلع  كلام  فاضي  لانو  اذا  ضربت  سوريا  الاردن  رح  اتصير  حرب  عالميه ثالثه  وما  رح  اتخلص  غير  لما  نتخزق	Negative
 ربنا  يثبته	Positive
 ربنا  يكرمك يا  دكتور	Positive
 فضحتونا  من  وين  نحنا  بال  48  عننا برامج  هيك  تافها  ومخمج	Negative
 بنص  المقطع  سقاله  موطبيعيه	Negative
 الله  يثبت  قلبك علي  ديننا الاسلام	Positive
 نحن  في  الاردن  نشاطر  اخواننا في  السعوديه  احزانهم بوفاه  الامير  سعود  الفيصل  وزير  الخارجيه  السعودي  السابق  انا  لالله  وانا  اليه راجعون	Negative
 اللهم  انا  نشكو  اليك ضعف  قوهنا قله حيلهنا حسبنا الله  نعم  الوكيل	Negative
 نت  عايش  خارج  البلد  عموما  ان  كان  نقاشك فرد  عضلات  مافيه  داعي  اكمل  حواري  معك	Negative
 هذه  من  اقوال  الرفيق  المناضل	Positive
 ربنا  يهديني ويجعلني من  الخاشعين  والمسلمين  اجمعين	Positive
 ربنايحفظك  ياشيخ	Positive
 لجنه حكم  ماعندها  ذره  احترام	Negative
 سنبقي  داءما  معا  نشاطر  بعضنا البعض  مر  الحياه  وحلوها	Positive
 التخلف  بعين  امه وعين  ابو  في  جامعات  الاردن  والزعرنه  والفساد  والفسق  والعشق  الممنوع	Negative
 كل  يوم  يصدمنا الاعلام  بنتاءج  رقميه مجهوله المصدر  والتوثيق  والاستقراء  حول  التعليم  في  الاردن  لتبرروا  تغير  المناهج  المخزي  لا  لن  تخدعوانا	Negative
 انا  لو  مكان  راغب  اروح  انتحرر	Negative
 شبابنا زي  الورده  بس  بدهم حدا  يدعمهم	Positive
 لا  هديله  بالجزمه  طبعا	Negative
 لن  يقفل  باب  مدينهنا فانا  ذاهبه لاصلي  سادق  علي  الابواب  و  سافتحها الابواب  و  ستغسل  يا  نهر  الاردن  وجهي  بمياه  قدسيه و  ستمحو  يا  نهر  الاردن  اثار  القدم  الهمجيه	Positive
 الله  الكلام  الجميل	Positive
 حقا  مزبوط  صدقت	Positive
 كيف  يجتمع  ستر  وغض  البصر	Negative
 نعم  الله  علي  اكثر  من  ان  احصيها الهدايه  ,  الصحه  ,  سلامهالقلب  ,  ذكاء  العقل  ,  صفاء  المشاعر  ,  سلامهالحواس  ,  حفظ  الاحباب  اللهم  لك الحمد	Positive
 لو  يدرس  في  جامعات  مصر  او  الاردن  يعرف  الدراسه  والعلم  الحقيقي  وهناك  اللي  يقدرون  نسبهه وتفوقه	Positive
 الله  حيهم هالشباب  انتوا  القدوه	Positive
 هذا  لا  يعني  خلوها من  الاشكال  المصديه	Negative
 اللهم  قني عذاب  النار  ادخلني جناهك	Positive
 احذفه اني بجلس  احش  فيهم لمين  اكفر	Negative
 برنامج  معوق  ومشاركين  معوقين  :	Negative
 الخشوع  امر  مهم  جدا  في  الصلاه	Positive
 عدوله السامج  هذا  خرب  اوم  المقطع  قسسم  زباله هالادمي  ودمه زفت  انا  ضحكت	Negative
 استغفر  الله  مجانين  يروحون  سوبر  ستار	Negative
 خليه  يرفع  لكن  اللي  عنده وطنيه انتماء  يصف  سيارهه بالشارع  يروح  علي  الشغل  مشي	Negative
 صباح  الخير  والسعاده  لكم	Positive
 صرماتي  براس  اهلك	Negative
 و  الي  اسماء  الاسد  كس  اخت  زوجك :	Negative
 ربنا  يكرمك علي  سعيك وحبك لالمساعده	Positive
 من  جد  مجنون	Negative
 يشبه  رغد  مجنونه هيافاء	Negative
 والنعم  والاخلاق  والنعم  والصداقه  والنعم  الاخوه	Positive
 لن  تموت  نفس  حتي  تستكمل  رزقها اجلها	Positive
 ربنا  يقويكي  علي  اخد  القرار  الصح  واحسني الظن  بالله  وتوكلي  عليه وربنا يقويكي  علي  ضعفك يارب  ويعدك عن  الغلط  ده	Positive
 افتخر  اني مسلم  نعمه من  نعم  ربي	Positive
 كل  شء  في  حب  الله  تهون  وحب  ربنا اقوي  بكتير  من  اي  حاجه	Positive
 اسوء  شعور  لما  تتاسف  و  تندم  علي  شيء  ما  سويته لما  كانت  الفرصه  متاحه امامك .	Negative
 الله  وكيلك مشحطط  اهل  دابوق  دير  غبار  عبدون  منعم  علي  الفقراء	Negative
 يا  اخي اطلع  في  صورهك بالمرايه  وشوف  اداءك هوه  اداء  فني   صوت  مناسب  قبل  لا  تفضح  حالك في  هيك  برامج  تافهه	Negative
 هو  رحيم  بكل  شيء  في  الكون  هو  الخالق  فلابد  ان  يرزق  مخلوقاته	Positive
 الحمد  لالله  علي  نعمه الاسلام  وكفي  يها  نعمه	Positive
 الله  يسامحك  حبيبتي  افهمتيني  غلط	Negative
 الله  اخترت  اسم  غالي  علي  قلبي قوي  ربنا يثبتك علي  دين  الاسلام  اخترت  صح  بجد	Positive
 بقرف  زيك	Negative
 الله  يخزيك	Negative
 اللهم  اعني  علي  ذكرك شكرك حسن  عبادهك	Positive
 هذا  اللي  بالنص  من  لجنه الحكم  مفكر  نفسو  وديع  الصافي  هو  شقفه علاك	Negative
 لكن  لالاسف  عننا كلمه معاق  في  الحياه  العامه  في  الاردن  تستخدم  لالتعبير  عن  الشخص  الغبي  علشان  هيك  انا  قلت  ذوي  الاحتياجات  الخاصه  افضل	Negative
 يا  رب  يا  خير  الرازقين  ارزق  اهل  سوريا  جميع  المسلمين  النصر  الثبات  التقوي	Positive
 سلمت  يمنيك كلام  من  ذهب	Positive
 لا  وحده مع  القران  هو  انيسي  ام  الغرام  فلا  احتاجه مطلقا	Positive
 اتفه  علي  هيك  برنامج  عالمي	Negative
 واطي وماجور  وسافل  ومنحط  وكريه وغبي  وسطحي  وحقو  قرش  مصدي  وبيسوي  صرمايه	Negative
 الله  يفرح  الكل  ويجمع  بين  المتحابين  علي  خير	Positive
 ماعندك  شرف	Negative
 انا  معك بان  دين  الاسلام  لكل  الناس  وفي  كل  زمان  ومكان	Positive
 اللهم  انا  نعوذ  بك  من  غضبك نساللك  رضاك	Positive
 الشعب  الذي  اختار  نواب  خرجين  سجون  سوابق  بستاهل  اكثر  من  هيك  مشان  50  دينار  الله  لا  يرد  هيك  شعب	Negative
 الله  يخلف  علينا بس  ,  يقال  لا  فقر  اكثر  من  الجهل  ولا  غني  افضل  من  العقل  !  !	Negative
 اللهم  استخدمنا  في  طاعهك	Positive
 بدي اروح  عمره الله  ييسر	Positive
 من  يستمتع  برءيه  الناس  في  مواقف  محرجه فهو  سادي  غير  اصيل  نفسه ضعيفه مريضه	Negative
 من  توكل  علي  الله  يعانق  قلبه النور  الصفاء	Positive
 انت  واحد  ما  بتستا  هل  الجزمه	Negative
 لا  ربنا يرحمنا برحمهه	Positive
 دار  الزمن  وصار  الوسط  الفني  كله نفس  ذي  العاهات  ووضحكو  هما  علينا	Negative
 من  وين  انجيب  حرام  عليكم	Negative
 اخر  همي اني اتناقش  مع  اي  كاءن  حي  اواتجادل  بذات  اذاكان  عقيم  فكريا	Negative
 احلي  اشي  في  الحياه  الاستقرار  مع  زوج  صالح	Positive
 اعمل  ليومك غدك كن  متفاءلا  داءما  يا  صاحبي	Positive
 اكيد  طبعا  حب  ربنا احسن  من  حب  اي  حد  وانا  فعلا  عملت  كدا	Positive
 انت  واحد  حقير	Negative
 الله  المستعان  علي  كل  ظالم  فليس  باليد  حيله غير  ان  نقول  لا  حول  ولا  قوه  الا  بالله	Positive
 يا  مصلح  القلوب  اصلح  احوالنا يا  مسهل  يا  رب	Positive
 ويحطمو  رءوسهم بارجلهم	Negative
 بكتب  اوراق  الشجر  يقول  موهبتي  وانا  صغير  الله  يسامح  اللي  كاذب  عليه	Negative
 كلب  واطي	Negative
 الدين  ليس  بالمظاهر  الدين  المعامله  حياء  وادب  واحترام  وانتقاء  للالفاض  الطيبه	Positive
 كم  هي  ثقيله علي  لسانك .  .  فراءحه الدجل  والنفاق  بنظرات  عيونك !  !	Negative
 كلام  طيب	Positive
 اللهم  ان  كان  رزقي بعيدا  فقربه لي ان  كان  قريبا  فيسره لي وان  كان  كثيرا  فبارك لي فيه	Positive
 الارواح  جنود  مجنده  من  تعارف  منها اتلف  ومن  تنافر  منها اختلف	Positive
 شو  هالغباء  فضحتنا	Negative
 الاعتداءات  علي  المعلمين  والاطباء  .  .  .  جراءم  لا  تقبل  اي  تبرير	Negative
 كس  امكم يالعرب  يابهايم  يابقايا  حضارات  الامم	Negative
 معك حق	Positive
 مياعه  وسءاله  من  عدوله والي  معو	Negative
 العجوز  هذا  والرجال  الي  بجنبه بله واغبياء  وانهم يثبطون  الواحد	Negative
 صح  كلامك احلي  حكمه محد  يبقي  لالنهايه  رغم  اتفاق  الطرفين	Positive
 ربنا  يهدينا يهدي  بينا  امه محمد  الغافلين	Positive
 قرف  يقرفك	Negative
 اسعار  البنزين  مرتفعه في  المملكه  الاردنيه  الهاشميه  والشعب  اغلبه فقير  وماشيه الحياه  بدون  اي  مشاكل  لكن  اللي  يقهرك ان  الاردن  لا  تنتج  البنزين	Negative
 من  المدرب  مرورا  بالمدافعين  والوسط  الي  المهاجمين  كلهم كانوا  في  اسوء  حالاتهم	Negative
 يا  رب  اللهم  اجعلني  خير  منما يظنون  اغفر  لي ما  لا  يعلمون	Positive
 ربنا  اصلح  احوالنا	Positive
 من  يوم  شفهك حاطه صورهك غسلت  يدي  منك	Negative
 اللهم  احينا  وامهنا علي  الاسلام  وعلي  كلمه لا  اله  الا  الله	Positive
 ربنا  يسهل	Positive
 كاميرا  خفيه في  الانحطاط  الاخلاقي	Negative
 انا  احب  هذا  الكاتب	Positive
 حرام  والله  حزنت  عليه شو  هالموقف  الشنع	Negative
 فعلا  البت  جده لما  تحتاج  ليه هو  الانسان  الصادق  هو  البستاهل  تضحي  عشان	Positive
 يا  اخي وين  ما  تروح  بالاردن  تخطي  مناطق  الشخصيات  المهمه  بالبلد  الباقي  كله مكرهه صحيه	Negative
 فعلا  والله  هو  القرار  والثبات  عليه	Positive
 كس  اختك	Negative
 الله  يرحم  هلبلاد  من  الحراميه  والمتسلقين  علي  قوت  الشعب  لك الله  ياشعبنا	Positive
 بعرف  بس  مو  حلو	Negative
 والله  نوفي  صح  لسانك	Negative
 لا  حول  ولا  قوه  الا  بالله  العظيم  لم  اكن  اعلم  ان  نسبه ذكاء  العرب  منخفضه جدا  الي  هذا  الحد	Negative
 وانت  اسكت  لا  تتحطم	Negative
 اميره ممكن  اضافه  لو  سمحتي	Positive
 اننا نعيش  في  زمن  بلا  رحمه	Negative
 انا  ابو  عدوله هذا  لو  قدامي  صدق  اني راح  العن  ابو  من  جابه	Negative
 نجدد  قلبنا بالايمان  مع  بعض	Positive
 اللهم  لا  تدع  لي ذنبا  الالا غفرهه اللهم  اصلح  لي ديني	Positive
 الا  لعنه الله  علي  الشيعه  الي  يوم  الدين	Negative
 اللهم  لا  اعتراض  علي  حكمك ارزقنا  انت  خير  الرازقين	Positive
 صباحك سعيد	Positive
 اللهم  اني اسالك فعل  الخيرات  و  ترك  المنكرات  و  حب  المساكين  و  ان  تغفر  لي و  ترحمني و  تتوب  علي	Positive
 صباح  التفكر	Positive
 اصلا  المغتربين  ماعاد  بدهم جامعات  الاردن  ,  عل  فكره في  دول  ثانيه  وجامعات  ثانيه  اقوي  ,  خليها للذنيبات	Negative
 ما  اجمل  الوفاء	Positive
 في  خطبه وحده رفض  شيخ  اخواني النووي  الاردني  و  مدح  النووي  الايراني	Negative
 عمدا  فيهم ما  نستعمل  التدفءه  نلبس  فروه	Negative
 ما  سال  لالله  الهادي  الخالق	Positive
 نفسي يوم  اكل  وانا  مش  مستعجله	Negative
 اللهم  نقي  نفوسنا اجعلنا  لك من  المخلصين  سرا  جهرا	Positive
 قصه راءعه  افادك الله  من  العلم  لتفيدنا داءما	Positive
 لنفترض  جدلا  ان  لا  اضرار  صحيه بيءيه سينتج  عن  بناء  مفاعلات  نوويه  سلميه دعوانا نفكر  في  الكلفه  من  حيث  اولا  :  كلفه بناء  عاليه  جدا  لعدم  امتلاكنا لهذه  التكنولوجيا  علي  شكل  ديون  تثفل  كاهل  العشر  اجيال  القادمه  ثانيا  :  لنفس  السبب  سنستورد  خبراء  لالتشغيل  لسنوات  طويله منما يزيد  كلفه الطاقه  ليس  العكس  ناهيك  عن  حصول  اي  اخطاء  مفترضه مستقبلا  ثالثا  :  اين  هو  المكان  البعيد  عن  المدن  في  الاردن  واين  مصدر  المياه  الكافيه  لالتبريد  رابعا  :  من  حق  المواطنين  اصحاب  القرار  الحصول  علي  تقرير  منشور  لالاثر  البيءي  مسبقا  بنفس  الوقت  نستطيع  الحصول  علي  نفس  كميه الطاقه  من  الصخر  الزيتي  الذي  نمتلك  منه احتياطي  هاءل  من  الغاز  الطبيعي  المءمل  مستقبلا  من  الطاقه  الشمسيه  من  طاقه الرياح  بكلف  نسبيا  اقل  بكثير  من  النووي  دون  اعباء  ديون  اضافيه	Negative
 بعدين  حتي  الدول  الي  اعلنت  انهاء  المفاعلات  النوويه  زي  اليابان  تراجعت  عن  قراره	Negative
 سيء  جدا	Negative
 لاتنساني  من  دعاءك الصالح  شيخنا	Positive
 احسن  شيء  العمل  الذي  يءدي  لالاستمراريه	Positive
 حبيبي  شرلبوني  يموت  شرلبونا  انا  مدريدي  ?  لكن  ماني مغير  لعيونه	Negative
 المسلسلات  خربت  بيوت  العالم	Negative
 ومن  منطلق  المسءوليه  التاريخيه  لالهاشميين  تجاه  المقدسات  ياتي  اهتمام  الهاشميين  بالقدس  ومقدساتها	Positive
 بعين  الله  يا  امال  كلهن ستين  سبعين  سنه وبمضن  وبتهون	Negative
 الله  الله  عليك يا  استاذ  عمر  بارك  الله  لك بارك  عليك جزاءك الله  عننا خيرا  كثير	Positive
 لالبرنامج  التافه  الي  يسمح  لهذا  الشي	Negative
 اين  ذهبوا  العلماء  والمخترعين  والمفكرين  جرب  في  جرب	Negative
 هادي  الاخوه  الصادقه	Positive
 تخسا  هما  وكل  واحد  بشد  علي  يدهم مشكلتو  شعب  سوري  يدعون  البراء  وهم  في  قمه النذاله	Negative
 حسبنا الله  نعم  الوكيل  في  اناس  همهم تجويع  الشعب	Negative
 ولكوم  ما  نحن  ميتين  من  دون  هالوسطه	Negative
 قصه في  منتهي  الروعه	Positive
 لو  كان  لالحب  راءحه .  .  لكانت  راءحه القهوه  في  يوم  ممطر	Positive
 تفو  كس  امك حماره	Negative
 تويتر  صاير  ممل	Negative
 كله علي  راس  المواطن  ما  يثير  السخريه  رفع  اسعار  المستقات  النفطيه  المستخدمه  في  الصناعه  تقول  صناعهنا مكسره الدنيا	Negative
 اللهم  اجعلني  من  يتشرف  به الاسلام	Positive
 انت  مو  انت  انت  جوعان  كل  شوكولاته  افرح	Positive
 يا  الله  ما  احلاه من  خبر  والله  فرحتوني	Positive
 اشهد  الله  اني احبك في  الله  ادعوا  ان  نحشر  مع  حبيبنا امامنا محمد  صلي  الله  عليه سلم  في  الجنه  امين	Positive
 جورج  وسوف  حلب  مو  طبيعي	Negative
 ثبتك الله  يا  استاذي ونصرك	Positive
 نيله تنيلكم من  وين  جايبين  هالحثانه	Negative
 وين  القناه التافه  الي  تعرض  هذول  المعاتيه  صحيح  نحن  في  انحطاط	Negative
 الله  الله  علي  اخلاق  الصحابه  اصحاب  رسول  الله	Positive
 هالانسان  مجنون  لابس  بدله رياضه  وجاي  يغني  حتي  لو  صوتك زين  اللبس  عدل	Negative
 احسن  اظن  بالله  وتوكل  عليه وحده	Positive
 دخيل  عينك يادكتور  كلامك ذهب	Positive
 الغموض  لغه  لا  يتكلم  بها الا  من  ذاق  متاعب  الدنيا	Negative
 اللهم  كما  حسنت  خلقنا حسن  اخلاقنا	Positive
 لازم  اخر  ما  توصل  اليه العقل  البشري  من  غباء  اخوكم حمزه اللهواني  من  الاردن	Negative
 قلت  ادب	Negative
 هل  الثقه  بالمشتركين  الزياده  لدرجه العمي  او  ان  محيطهم يجاملهم  بجمال  صوتهم	Negative
 مشاهد  وسخه	Negative
 نحن  نرفض  المفاعل  النووي	Negative
 الحكم  سيء	Negative
 ليش  معصب  يا  عدوله	Negative
 انتم  يا  قطريه شن  عارفكم السياسه  انتم  لاعندكم  جيش  ولا  استراتجيه  ثابته انتم  عملاء  امريكا  يا  خونه	Negative
 ماشاء  الله  عليكم بجد  موضوع  مهم  جدا  والاهم  الرقي  الراءع  في  الحوار	Positive
 جمهور  لا  يياس  الي  اخر  ثانيه	Positive
 اللهم  اعز  المسلمين	Positive
 انا  اردني  بقول  الشعب  بيستاهل  غلا  اكثر  من  هيك	Negative
 معلم  في  حقيقه عمله هو  مدرب  يدرب  طلاب  علي  اكتساب  المعرفه  لا  مجرد  تلقيها	Positive
 والله  كذب  من  سوبر  ستار  القذر  هذا	Negative
 سلمت  سلمت  يداك انها الاخلاق  الكريمه  التي  علمنا اياها رسولنا الاعظم  صلوات  الله  سلامه  عليه اننا انشاء  الله  سنفعل  ما  بوسعنا حتي  نرسم  صوره راقيه جميله عن  ديننا اخلاقنا الله  المستعان	Positive
 هع  مش  حلو	Negative
 وبكل  تبلد  اعترف  لكم باني اقل  نساء  الارض  صبرا	Negative
 لوين  ندكم توصلوانا الله  هموم  المصاريف  قتلت  الصغير  قبل  الكبير  الله  ياخذ  حقنا منكم لا  يباركلكم	Negative
 لاتتحدث  بقوهك امام  ضعيف  ,  و  لا  بسعادهك امام  حزين  ,  و  لا  بمالك امام  فقير  ,  زن  كلامك و  راع  شعور  الاخرين	Negative
 ربنا  يصلح  حالنا جميعا	Positive
 بطني وجعتني من  الضحك	Negative
 البرنامج  الي  بعد  سوبر  ستار  الي  يقلده دم  ثقيل	Negative
 هع  بدها بس  تعلق  التعليقات  الزنخه	Negative
 وجعلنا من  الماء  كل  شيء  حي	Positive
 عليا  النعمه  ابدا  لا  هو  ولا  الخروف  التاني	Negative
 وهابي  عفن  ومكبوت  تفكيرك محصور  بين  فخذيك فقط  لاغير  الجنه  اللتي  ستدخلها انت  لا  اريد  دخولها جهنم  اشرفلي  واهون  علي  من  ان  اكون  مع  احد  الوهابين  المنحطين  لواطيي  الاطفال	Negative
 انا  علي  ثقه  اني استطيع  فعل  اي  شء  اني انا  من  صنع  الله	Positive
 شردو  اطفلها  وقتلوا  رجالها	Negative
 وان  مدحتك بالقصاءد  ماوفيت	Positive
 اكرمك الله  يا  استاذي الفاضل	Positive
 تركنا  كل  شء  من  اجل  رضا  الله  اللهم  ارضي  عننا	Positive
 ان  الجميل  اذا  اخفيته ظهرا	Positive
 هءلاء  معوقين	Negative
 ما  اجمل  الصبر  الاصرار	Positive
 سخيفه قوه	Negative
 سعادهنا تكون  بحسن  الاستمتاع  بالاشياء  التي  نحصل  عليها كما  تكون  بحسن  الاستغناء  عن  الاشياء  التي  نحرم  منها	Positive
 يارب  اجعلني  من  الصالحين	Positive
 مثال  جميل  جدا  عبره لكل  من  يحمل  رساله  الاسلام	Positive
 اكيد  ماحدا  بيقدر  يارب  اعن  الفقراء  واعنا  مساعدههم	Positive
 اسخف  لجنه تحكيم  شفهها بحياتي	Negative
 كلنا ما  انتصرنا  علي  نفسنا وعلي  الحاجه  ددي  الي  متعبهنا ومبعدهنا عن  الله	Positive
 مفيش  اجمل  من  ان  الانسان  يحافظ  علي  كرامهه	Positive
 و  تربت  علي  كتوفنا  تشحننا بالتفاءل  ايضا  صباحك اسعد	Positive
 ماكل  روح  الخل	Negative
 عاهات  اللهم  لاشماته	Negative
 الا  يكفي  ان  نسبه مرضي  السرطان  في  الاردن  اعلي  نسبه عالميه بسبب  مفاعل  دايمونه  الاسراءيلي  بكل  جهل  نضعهه  في  بلدنا	Negative
 نعم  الاخ  وما  اطيب  قلبه	Positive
 اندهش  لما  عرف  الحقيقه	Negative
 اللهم  اذقنا  حبا  راءعا  حلالا  طاهر	Positive
 شوف  شكلك بالاول  بعدين  احكي	Negative
 الف  الف  مبروك  يستاهل  والله  يوفقكم	Positive
 فعلا  في  البدايه  كلهم راءعون	Positive
 الي  انا  شايفو  انو  المفاعل  راح  ينعمل  في  الاردن  راح  يخدم  دول  تانيه يعني  مش  عشان  سواد  عيونا	Negative
 كن  مع  الله  لا  تبالي	Positive
 اللهم  كن  مع  اخواننا في  سوريا	Positive
 من  دون  التفاءل  ما  في  حياه	Positive
 معتيه  واضح  انهم يمثلون	Negative
 وقعنا  ولا  ما  وقعنا  يللي  بدهم يعملواه بيعملوه	Negative
 يرزق  من  يشاء  بغير  حساب	Positive
 يا  عطاء  يامنان  يا  اكرم  الاكرمين	Positive
 الله  غلي  المسلمين  في  توادهم وتراحمهم	Positive
 عاهاتك ياعرب	Negative
 سبحان  الله  مالك  السموات  الارض	Positive
 الاسلام  نعمه كبيره من  عند  ربنا لا  تقدر  بكنوز  الدنيا  كلها	Positive
 واي  ناس  فاظيين  صج  عاهات	Negative
 يا  ربي هذا  مستحيل  يكون  كاءن  بشري	Negative
 الوحيد  الذي  لايتركني  ولو  لحظه	Negative
 اسال  الله  ان  يرزقني من  يدعو  لي في  ظهر  الغيب	Positive
 ايوه  هيك  بدنا  ياكم  يا  شباب  بترفعو  الراس	Positive
 يهدي  الله  من  يشاء	Positive
 حفظ  سور  جديده تسميعها  في  الصلاه  يساعد  علي  التركيز	Positive
 المراه  تهان  وتعامل  كاداه جنسيه تحت  مسميات  عديده كالمسيار  والمسفار  والمصياف  الخ  وكلو  بتمنو	Negative
 اللهم  احسن  خواتيم  اعمالنا اجعل  كل  اوقاتنا طاعه	Positive
 يجب  وضع  كل  من  تسول  له نفسه مجرد  ان  يعمل  اي  تصرف  لا  يليق  بالاردن  ان  يسجن  يسجن  شيء  مخزي  شويه  همل  زعران  يخربوا  الجامعات  سمعه البلد	Negative
 انشاء  الله  هنعمل  حاجه  تفتخرو  فيها	Positive
 عاهات  العرب  الجرب	Negative
 هاد  كلو  كزب  ياهبله  والله	Negative
 اللهم  اجعلنا  منمن يعطي  الامانه  حقه	Positive
 قصه جميله تعلم  الناس  كمان  الامانه  لان  اذا  اخذ  القليل  اخذا  الكثير	Positive
 شعب  سخيف	Negative
 طريق  واحد  عدم  اليءس  هو  طريق  النجاح	Positive
 اكيد  جزاءك الله  خيرا	Positive
 برك  الله  فيك وجعلها في  مزان  حسناتيك	Positive
 والله  عاهات	Negative
 لكل  مجتهد  نصيب  .  .  .  من  لديه هدف  ويثابر  عليه حتما  بعد  امر  الله  سوف  يصل	Positive
 اوقف  القرار  لالحفاظ  علي  الوطن	Negative
 الله  لا  يشبعكو  يا  ظلمه انشاء  الله  كلو  بتلقو  بالاخره  يا  ظلمه خافوالله  طبعا  اذا  بتعرفوالله	Negative
 سخافه بكل  ماتحوي  الكلمه  من  معني	Negative
 وانا  100  %  بس  شكلها هاي  مو  مدرسه	Negative
 مهيه  خربانه ان  شاء  الله  يعملو  مفاعل  قرد  بطلت  تفرق	Negative
 والله  هذا  الي  حصل  معينا ومع  ناس  كثيره بدل  حب  الحرام  بحب  الحلال  يبدل  الله  كيانك	Positive
 ما  بدي غير  10  يعملو  لايك  للبيج	Negative
 ابشرك فيه تحسن  ولالله  الحمد  باذن  الله  يرجع  قريبا	Positive
 وش  يحسون  فيه يع	Negative
 كلام  صحيح  من  شان  هيك  الدول  اللي  ما  فيها بطاله والمجتمعات  المفتوحه  بتقل  فيها المشاكل  النفسيه	Positive
 الغلط  مو  من  المشاركين  الغلط  من  نفس  البرنامج  المفروض  تكون  في  مرحله فرز  في  البدايه  قبل  لا  يطلعو  الهواء	Negative
 والله  حرق  لاخوات  الكلب	Negative
 هل  كلها صالحه لالاستعمال  ولا  من  اول  استخدام  تنفجر	Negative
 وليه امرك الوهابيين  يكرعون  الخمر  والسديقي  كرعا  بالسر  والعلن  دون  تطبيق  الحدود  عليهم	Negative
 والله  لو  انه فايز  بعرب  ايدول  او  من  هل  برامج  الفارطه  غير  تلاقي  اضعاف  هذا  العدد  ياعمي  شعب  بحب  السح  اندح	Negative
 العاهات  اللي  عندهم ياناس  روحو  موتو  اشرف	Negative
 حطمت  كل  احلامي البريءه	Negative
 نشاطر  اخوهنا في  الاردن  احزانهم علي  الاغتيال  الوحشي  لالطيار  معاذ  ـ  الكساسبه  داعين  الله  ان  يكون  من  الشهداء  و  ان  يسكنه فسيح  جناته	Negative
 الحمد  انا  متفاءله  جدا  في  كا  امور  حياهي ورح  اضل  هيك  داءما	Positive
 لا  مش  فاهماك	Negative
 ما  احسنهم الله  يكون  معهم	Positive
 صوره مليانه  روح  ,  يعلم  الله  اني سعيد  جدا  فيها ففيها شباب  حافظين  لكتاب  الله	Positive
 الحمد  لالله  الذي  بنعمهه تتم  الصالحات  حمدا  غير  منقطع	Positive
 ولا  تنسو  تبسمك في  وجه  اخك صدقه	Positive
 شو  عاجبك  فيها مثلا  ?  لتكون  سيارهكم	Negative
 عنجد  هذا  الانسان  تافه  وحقير	Negative
 يجب  داءما  ان  نعتني بالورود  لكي  تكبر	Positive
 ما  اقسي  غربه الروح	Negative
 كن  كما  انت  لا  تتغير  من  اجل  احد	Positive
 صباح  الورد  لوجه  طيبه	Positive
 الواحد  عايش  وسط  قرف	Negative
 يتسابقون  الي  جهنم  و  باس  المصير	Negative
 اللهم  اهدنا  فيمن  هديت  وعافنا فيمن  عافيت	Positive
 لسنا  مجبرين  علي  تبرير  المواقف  لمن  يسيء  الظن  بنا من  يعرفنا جيدا  يفهمنا جيدا  فالعين  تكذب  نفسها ان  احبت	Positive
 المراه  كلها عوره حتي  صوتها عوره	Negative
 الله  يزيدك من  العلم  ما  تنتفع  به الامه	Positive
 الروح  و  المال  تفداك يا  قلبي	Positive
 صباح  العفو  والتسامح  صباح  الخير  لوجه  الخير	Positive
 سخافه الشاميين  ابدا  ما  ينفع  لهم الكوميديا	Negative
 اطالب  برحيل  هذه  الحكومه	Negative
 الاسلام  هو  حسن  الخلق  الالا تعرف  بان  الحبيب  صلي  الله  عليه سلم  لقب  امينا  قبل  نزول  الوحي	Positive
 عن  جد  انتي  ما  شاء  الله  عليكي  جزاكي  الله  كل  خير	Positive
 لا  شو  انا  مسخره كلكو  خنازير	Negative
 يا  ريهك ما  كبرت	Negative
 كسم  العته  البشري	Negative
 كافر  ملعون  جهنم  باذن  الله	Negative
 يلعن  ابو  هل  الاشكال  بس	Negative
 برامج  سخيفه تهدف  لهدم  الامه	Negative
 صباحات  النقاء  الابتسامات  الصافيه  من  القلب	Positive
 الله  يلعن  ام  هيك  نمر	Negative
 لا  مو  حلو  و  بخزي	Negative
 خير  صديق  في  الزمان  كتاب	Positive
 صار  عناد  وكره قله ادب  بس  ظلموها	Negative
 اسال  الله  عزوجل  له الثبات	Positive
 يا  لطيف  الله  يلطف  فينا يصلحنا ظاهر  باطن	Positive
 حتي  نعرف  نحل  مشكله المجاري  بعدين  منعمل  مفاعلات	Negative
 قصه جميله جدا  تعكس  معني  الايمان  التمسك  بالعقيده  الصحيحه  حسن  تعاليمها	Positive
 تبتنا ياربن  علي  دكرك  وشكرك حسن  الخشوع  في  صلاهك	Positive
 اهلا  وسهلا  بك  بيننا يا  طارق	Positive
 انبسط  يا  عم  افرح	Positive
 اهلا  وسهلا  بشخصك الكريم	Positive
 سلوا  الله  الجنه  والحوا  عليه في  طلبها ييسر  لكم اسباب  دخولها فكل  نعيم  دونها شقاء  وكل  فوز  دونها خسار  فمن  زحزح  عن  النار  وادخل  الجنه  فقد  فاز	Positive
 نقطه النهايه  وداعا	Negative
 لالاسف  البعض  يعتقد  ان  المفاعل  النووي  سيحل  مشاكلنا الاقتصاديه  ولكن  الاردن  لا  يمتلك  موارد  ماليه وهذا  يعني  الحاجه  لشريك  اجنبي  كما  اعلنت  هيءه  الطاقه  يملك  غالبيه  الاسهم  كما  في  تركيا  علي  سبيل  المثال  وذلك  يعني  ان  هذا  الشريك  سيمتلك  الجزء  الاكبر  من  المفاعل  ولن  يكون  ملك  لالاردن  وبالتالي  ستقوم  الحكومه  ايضا  بدفع  تكاليف  الكهرباء  لالمستثمر  وبالتالي  المفاعل  النووي  لن  يوفر  لك الكهرباء  بسعر  قليل	Negative
 اضحك  وفرفش  لكن  بحب  واداب  اعرف  حدود  المزح  واعرف  محله	Positive
 القتل  نهايه  الزوجه  اللعوب	Negative
 هذا  صدق  ولا  مجنون  ولا  يستهبل  وش  القصه	Negative
 ما  شاء  الله  .  .  .  ونعم  التعليم  في  الاردن  .  .  .  .  ابدعوا  الشباب  !  !  !	Positive
 مخالفات  السير  اصبحت  تشكل  عبء  اقتصادي  علي  المواطن	Negative
 حتي  بالستايل  مقلده  الله  ياخذ  عمره الغبي	Negative
 اذا  كنا  بالفعل  علي  موعد  مع  رفع  لاسعار  الخبز  كما  يشاع  ,  فالاولي  بالحكومه  اولا  ان  تقوم  بترشيد  الدعم  بحيث  يذهب  فقط  لمن  يستحقه !	Negative
 الراجل  الابس  ثوب  عليه جاكيت  شكله مسطول  من  جنوب  السودان	Negative
 شكلك دايما  متاخره  عن  المدرسه	Negative
 ما  شاء  الله  جميله جدا	Positive
 جسمها حلو  ترقص  عاريه	Negative
 يارب  اهدنا  وقوي  عزيمتا  الي  ما  تحب  وترضي	Positive
 و  بحب  الناس  الرايقه  الي  بتضحك  علي  طول	Positive
 عطله 15  يوم  وكمان  اسبوع  عطله و  20  دينار  لكل  طالب  هاي  مدرسه ولا  شهر  عسل	Negative
 ما  ارحمك يا  ربي بخلقك سبحانك يا  حبيبي  يا  الله	Positive
 ارجوك يا  استاذنا الفاضل  ادعيلي  بالنجاح  في  مسابقه المجستير  العام  القادم  والشفاء  بارك  الله  فيك	Positive
 وانا  مع  انو  الطاقه  الشمسيه  هي  البديل	Negative
 تنظرون  لا  الشام  يقتلون  بدم  بارد	Negative
 كن  ايجابيا  وتذكر  ان  قليلا  من  التفاءل  قد  يصنع  الف  طريق  نحو  السعاده  صباحكم مليان  طاقه ايجابيه	Positive
 والله  ايلي  اختشه ماتوا	Negative
 خسءو  وخسء  امثالهم ومن  طاوعهم	Negative
 متفقين  معهم البرنامج  خايس	Negative
 من  زمان  ما  شفت  مخلوقات  فضاءيه	Negative
 سلمت  يداك روعه	Positive
 لو  اغلقت  الابواب  في  وجهك واظلمت  الدنيا  خنقهك الدموع  و  ضاقت  بك  الارض  استحضر  معني  اسم  الله  الفتاح  القادر  سبحانه قادر  علي  فتح  ما  انغلق  من  امرك	Positive
 غيب  عن  وجهي	Negative
 كيف  لا  احبه و  في  كل  مساء  يهديني شيءا  من  روحه	Positive
 يارب  قربني اليك واقترب  لي اكثر	Positive
 بارك  الله  في  دين  الاسلم	Positive
 انا  فعلا  عملت  كده والحمدلله  بقيت  احسن  من  غير  الحجات  الي  ربنا خدها مني الحمدلله	Positive
 عيب  عليك ماتستحي	Negative
 تفاءلوا  بالخير  تجدواه اعملوا  الصالحات	Positive
 الاردن  لديه الخبره  في  مجال  اداره  الموارد  البشريه  واستخدام  هذه  الامكانيات  بافضل  مايمكن  لتوجيه  اقتصاد  الدوله	Positive
 بطلت  كتير  وكل  ما  اترك  والتزم  مع  ربنا برجع  تاني  وكل  اما  ارجع  ارجع  اكتر  من  الاول	Positive
 يعني  بكل  وضوح  بدكوا  تذلوا  الشعب  الاردني  تخلواه كل  شهور  يصف  طابور  عشان  يوخدلوا  اكمن  ليره	Negative
 الوفاء  اصبح  شء  نادر  يكاد  يكون  معدوم	Positive
 اللهم  قني شر  نفسي	Positive
 من  كانت  له عزيمه  لن  يياس  ومن  بغي  الاجر  من  الله  ثابر  حياكم الله  اخي  مءمن	Positive
 ما  شاء  الله  والله  انها امر  متل  الكرتون	Negative
 والله  شككني في  البرنامج  انه سوبر  ستار  او  برنامج  كوميدي	Negative
 انه النووي  ضرره علينا اكتر  بكتير  من  فواءده	Negative
 نادرا  ما  بتصير  لو  انه الشعب  بتطور  وبيتعلم  مع  الوقت	Negative
 الاخلاص  اللهم  انا  نسالك الاخلاص  في  القول  العمل  السر  العلن	Positive
 نعم  لنجعل  حب  الله  هو  الغايه  وربنا يسامح  كل  تاءب	Positive
 اللهم  اعنا  علي  انفسنا اجعلنا  نري  الدنيا  صغيره الاخره  كبير	Positive
 تفه عليك وع  شكلك اول  ما  نشهرت  طلقت  زوجها خنزيره	Negative
 اهما  ودهم يروحون  النار  لكن  النار  مارضت  فيهم	Negative
 يا  رب  بناتنا شبابنا كلهم يستطيعوا  العمل  بهذه  النصيحه  يا  ريتا  كلنا نتذكر  اننا كلنا دعاه لالاسلام  باخلاقيهنا الصفات  الحسنه	Positive
 الكرامه  فوق  كل  شيء	Positive
 اذا  الخبر  صحيح  انا  اول  شخص  بطالب  بالهجره  لاي  دوله خليجيه او  اوروبيه  او  حتي  اسراءيل	Negative
 السهر  احد  مسببات  مرض  السكر	Negative
 يعني  هيك  برامج  بتبين  لالناس  وين  صرنا كم  صارت  نسبه التخلف  بين  شباب  امهنا	Negative
 عذبت  ام  العود	Negative
 سافل  و  غشاش	Negative
 لا  يغير  الله  ما  بقوم  حتي  يغيروا  ما  بانفسهم	Positive
 احلي  شيء  النهايه  الباقيه  صح  كلامك	Positive
 يلعن  ابو  التفاهه	Negative
 ربك دايما  جنبك لو  ناديتوا  ها  تلاقه	Positive
 اليك يا  ربي قلبا  لم  يستعن  بسويك ,  ياوي  اليك لترضي  ويهتدي  بهديك	Positive
 اللهم  ارزقنا  الصحبه  الصالحه	Positive
 اللهم  لا  شماته ليش  ياربي  يحرجوا  انفسهم	Negative
 الضغوط  النفسيه  لها تاثير  في  النهايه  ,  سمعت  قصه عن  اشخاص  انتحروا  بسبب  تعليقات  ساخره ضدهم .	Negative
 والله  هبل  في  هبل	Negative
 الاردن  لا  تمتلك  اي  الخبرات  الفنيه  في  انشاء  او  صيانه  او  تشغيل  المفاعلات  النوويه  لاردن  ليس  لديها سوي  شهادات  دكتوراه  في  هذا  المجال  نظريه بحهه ان  انشاء  مفاعل  نووي  يعني  مقامره كامله بمءات  الملاين  المضحك  في  الموضوع  ان  بدايه المشروع  ستكون  انشاء  مفاعل  تجريبي  او  تعليمي  يتبع  لهيءه  الطاقه  النوويه  اليس  الاجدر  بهكذا  مفاعل  ان  يتبع  لاحدي  الجامعات  علاوه  علي  ان  كل  هيءه  الطاقه  تم  انشاها رضواه لفلان  وعلنتان  الاولي  يا  ساده ان  يتم  طرح  انشاء  شركه لالتنقيب  عن  اليورانيوم  وبيعه لتصبح  الاردن  دوله مصدره لهذه  الماده  امر  اخر  كثر  الحديث  مءخرا  عن  انه يوجد  في  الاردن  بترول  بكميات  علي  الاقل  تكفي  استهلكنا  المحلي	Negative
 ليش  ما  نتعلم  من  الي  صار  في  اليابان  وروسيا  المانيا  الغت  نظرهها في  بناء  مفاعلات  نوويه استخدام  الطاقه  البديله	Negative
 الي  ابن  بشار  الاسد  كس  اخت  ابوك	Negative
 يا  رب  استجب  دعاءنا وانصر  اهلنا في  سوريا	Positive
 من  بغضه رب  العالمين  لن  يحبه احد	Positive
 لا  تتهاون  بحجاب  زوجهك فهناك  رجال  في  الطرقات  في  قلوبهم مرض  يتمتعون  بالنظر  لنساء	Negative
 سنبقي  نذكر  دوله الشهيد  وصفي  التل  الذي  كان  رءيسا  لالوزراء  حبيبا  لالفقراء	Negative
 الغباء  واضح	Negative
 و  الناس  يدرون  شو  بقول  عنهم في  نفسي وهم  يتكلمون  ما  يكلمني حدا  نهاءي	Negative
 صباح  القشطه	Positive
 اللهم  اجعل  سريرتي  خير  من  علي  نيتي  اجعل  علي  نيتي  صالحه	Positive
 ربك دايما  جنبك لو  نديته هتلاقيه	Positive
 اتصور  لو  ظليت  ما  اتعلق  احسن  انه تعليقاتك مقرفه	Negative
 والله  شوي  وتجيني  جلطه  لما  ماطلعت  الاولي  ذيك  المره	Negative
 انا  شوفت  وقاحه بس  زاي  وقاحه الاخوان  ما  شوفت	Negative
 يا  تري  الحكومه  بدها تزيد  دعم  المواطن  الي  الله  يكون  في  عونه	Negative
 الله  يخزيكم عند  امن  الوطن  مافي  سلطي  ولا  كركي  ولا  طفيلي  الاردن  فوق  الجميع  قالوا  بنحبك يا  وطن  رد  عليهم الوطن  بغصه  حبوا  بعضكم اول	Negative
 اذا  لم  تقل  لا  لالظلم  فسيستمر  الي  الابد	Positive
 ربي  يزيدن  ايمان  وتقه يارب	Positive
 ما  بكره حد  قدك	Negative
 ماشي  هسا  انا  صرت  وله طيب  في  حدا  بيشبهك  كتتير	Negative
 هل  تعلم  ان  المطر  يتشكل  اولا  علي  هيءه  بلورات  ثلج  داخل  الغيوم  يتحول  الي  قطرات  ماء  بعد  ذوبانه هو  في  طريقه الي  اليابسه	Positive
 اذا  كان  المدير  يخاف  من  معلم  مبدع  وكان  زملاء  العمل  يحاربون  هذا  المعلم  فهم  في  الحقيقه  ينتقصون  من  حظ  طلابه	Negative
 انماما بعثت  لاتم  مكارم  الاخلاق	Positive
 اللهم  ارزقنا  رزقا  حلالا  تغننا به عن  حرامك	Positive
 ضع  امنياتكم في  سجده انساها وتاكد  ان  الله  لن  ينساها ابدا	Positive
 من  يتقي  الله  يجعل  له مخرجا	Positive
 عجل  يا  الله	Positive
 من  احبه الله  حبب  به خلقه	Positive
 ركز  في  الاجابه  وقول  يارب  وخد  قرار	Positive
 ولا  خير  في  امر  كرهت  ان  يطلع  عليه الناس	Negative
 اني احبك في  الله	Positive
 اللهم  ابعد  عني شهوات  الدنيا  وقربني منك واغفر  لي ولكل  المومنين	Positive
 يا  الله  ارحم  عبدك الفقير  المسكين  وجميع  المسلمين  والمسلمات	Positive
 من  قلت  الذوق  هذه  الافعال	Negative
 يالله  ما  اروع  هاءولاء  الناس	Positive
 اللهم  ان  كان  لي عوض  علي  صبري	Positive
 صار  بدها بطاريه  التقوي  شحن	Positive
 اسال  الله  في  علاه  ان  يحفظكم بما  يحفظ  به عباده الصالحون	Positive
 طالما  انك تتوجه  الي  الله  عز  وجل  باستمرار  فلسوف  يفتح  عليك اكثر  منما تتخيل	Positive
 اذا  غلبك امر  وعجزت  عن  التعامل  معه فكرر  يا  حي  يا  قيوم  برحمهك استغيث	Positive
 اللهم  ارضنا بما  قسمته لنا	Positive
 الاهم  نكون  صادقين  مع  نفسنا لنكون  صادقين  مع  الاخرين	Positive
 صبحك الله  بالخير	Positive
 كلام  جميل	Positive
 فاضل  قلمين  نخلص	Negative
 الله  يبارك  فيك انك غيرت  في  صاحبتي  كتير  وهي  من  المتءثرين  فيك وهي  اللي  عرفتني عليك	Positive
 هو  بن  وسخه ادمان  وبالذات  لو  متابع  اخبار  وحاجات  يوميه	Negative
 اللهم  اعني  علي  ترك  المعاصي  حبا  في  نور  وجهك	Positive
 الجنه  ما  تنطاق	Negative
 مرره دلوع	Negative
 عنجد  بخزي	Negative
 الي  يقارن  بينه وبين  مرسي  يبقي  متخلف	Negative
 مالكيش  حظ  في  اصحابك ولا  اهلك	Negative
 جد  اشي  بخزي	Negative
 يمتاز  الاردن  بتنوع  السياحه  فيه فتنقسم  السياحه  الي  سياحه علاجيه سياحه دينيه  سياحه معارض  سياحه اثار	Positive
 ليش  محشورين  علي  بعض  كذا  خلصت  الطاولات  مالقو  الا  الطاوله  الخايسه	Negative
 اللهم  اجعلني  مقيم  الصلاه  من  ذريتي	Positive
 السعي  وراء  الرزق  عباده و  جهاد	Positive
 والله  انك فشلت  العرب	Negative
 يارب  احمينا من  شرور  انفسنا وسي  ءات  اعمالنا	Positive
 متسمم  فكره الولد  وصارت  حالهه صعبه يا  حنين  انت	Negative
 ايها  الصغار  المتناكفون  انكم مع  كل  منشور  ضد  بعضكم البعض  تصغرون  اكثر  منما انتم  صغار  فلا  يسلك  هذا  الطريق  الا  صغير  ساذج  يحب  ان  يعيش  علي  القذارات	Negative
 الاردن  هذا  الي  كله فخر  واعتزاز  لمدح  مشروع  الطاقه  الشمسيه  في  الديوان  الملكي  كيف  شعوره لو  المشروع  طاقه نوويه  ?  !  شو  علاقه الفخر  والاعتزاز  ?  !	Negative
 ما  يستحون  هم  جايين  لو  انا  منهم اروح  اقشر  بصل	Negative
 الحمد  لالله  ما  اكرمك يا  الله	Positive
 فطست  ضحك  علي  الشايب	Negative
 والله  حرام  يعني  ما  يدرون  انهم مصخره	Negative
 لا  طبعا  التقرب  الي  الله  هو  خير  علاج  لالحالات  النفسيه	Positive
 غباء  في  غباء  لان  نفس  الحركه  صارت  في  يعني  قلدنه البرنامج  وبعد  التصرفات  اووف	Negative
 الله  ما  يحرمنا من  كلماتك الحلوه  يا  شيخنا	Positive
 ما  هيك  بيقولوا  لالاسف  ما  عجبت  حدا  انت  جاهل  يا  هذا  ليس  هكذا  تدعو  الناس  لقول  لا  اله  الا  الله  محمد  رسول  الله  انت  غبي  يا  صاحبل  هذا  البوست  لا  تفقه شيءا  من  العلم  الدين  انت  هيك  تبين  انك في  قمه الجهل  العار  قل  كلاما  جيدا  محببا  لا  تتلفظ  بالكلام  السيء  انماما تعجبنا كلنا لو  قلت  انطقوا  بالشهادتين  يا  اولي  الالباب	Negative
 يا  رب  اجعلنا  من  الصالحين	Positive
 من  اين  لنا المياه  لتبريد  المفاعل  النووي  فهو  يحتاج  الي  نصف  مليون  مترا  مكعبا  من  المياه  لتبريده سنويا  علي  الاقل  والقاصي  والداني  يعرف  اننا في  بلد  يعاني  من  شحه المياه  اما  كعلوم  معرفه  بالعلوم  النوويه  الطاقه  فانا  احب  ان  يتعلمها المتعلمين  في  بلادنا بدءا  من  جدول  مندلييف  لالعناصر  مرورا  العناصر  المشعه  نظريه اينشتاين  لالطاقه  نظريات  الفيزياء  الكميه  البحث  في  عمر  البروتون  النيوترينو  والكواركات  واللبتونات  وال  النظاءر  المشعه  تفتيت  الذره  اشعه  جاما  بيتا  الفا  الراديوم  البلوتونيوم  البروتونات  كافه النظريات  بما  فيها انواع  المفاعلات  النوويه  تجارب  الامم  فيها مثل  اليابان  المانيا  روسيا  فرنسا  امريكا  لالعلم  فقط  انها علوم  نظريا  سهله بسيطه يستطيع  فهمها حتي  الانسان  ذو  الخلفيه  الرغبه  العلميه  علي  جميع  او  علي  الاقل  جزء  من  @@علماءنا@@نا ان  يقرروا  المسار  الذي  يجب  ان  نسلكه نسير  فيه بهذا  الخصوص  بموازنه المخاطر  المكاسب  بعدها علي  اساس  النتيجه  الفاءده  الواضحه  يتم  الاعتماد  لقرارهم ان  كان  سلبا  ام  ايجابا	Negative
 يارب  اجمع  امهك علي  دينك يارب  وشت  اعداء  الدين	Positive
 الاكل  زاكي  كثير  كثير	Positive
 صدقهي راءعه معبره الكلام	Positive
 صراحه بخزي  من  دون  مجامله	Negative
 والمصحف  عاهات	Negative
 ربنا  يستر  واخلاق  المتاسلمين  لا  ترجعه مره اخري	Positive
 اشي  بقهر  مش  لا  هل  درجه	Negative
 خلتني اضحك  رغم  اني مكتءبه جدا	Positive
 هذا  سلامي  يسبق  البرق  الطير  فيه الحروف  معطره بالتحيه	Positive
 الطاقه  الشمسيه  هي  البديل  وليست  الطاقه  النوويه	Negative
 اول  واحد  ذكرني بصاحب  اسمه قرده	Negative
 اشرب  من  كاس  المر	Negative
 صباح  الامتحانات	Negative
 اللهم  اصلح  حالنا وشاننا كله واجمع  لنا خير  الامور	Positive
 تافهين  جدا	Negative
 لك كلك ذوق  حكمه	Positive
 مع  مرور  والوقت  وزياده  الالتزامات  والمسءوليات  قد  تنسي  ما  كنت  تستمع	Negative
 يارب  ثبتنا بعد  اخذ  القرار  لان  هو  ده  الاهم  الاصعب	Positive
 كل  شخص  فينا بيتمني  الخشوع  في  صلاته يا  رب  يتقبل  صلاتنا صيامنا	Positive
 تحيه لاهل  فلسطين  الغاليه	Positive
 مجانين  العرب	Negative
 يارب  تهدينا  الي  الصراط  المستقيم  يارب  تقبل  مننا	Positive
 مش  طبيعي  سماكه الدم  شو  ها  عدوله خرب  المفطع  لشو  المبالغه  والاوفر  يعني	Negative
 الحياه  مستمره سواء  ضحكت  ام  بكيت	Negative
 نسال  الله  العفو  العافيه	Positive
 اقسم  بالله  انه منتهيي	Negative
 يا  ربي  شو  هالولد  الله  مجنون  مبيستحييش  متاكدين  انو  مغربي	Negative
 يا  الله  عالمواساه  يرحم  ايام  زمان	Positive
 يا  اخوان  انتبهوا  الي  انه اكثر  المشتركين  المايعين  من  لبنان  او  سوريا  وهذا  حالهم لان  تركوا  مله الاسلام  وتبعوا  الميوع  مع  الشيطان	Negative
 فلما  الحزن  فلقد  اصبح  الحزن  صديقي	Negative
 طلعوا  العرب  اخس  واخس  واخس	Negative
 حسبنا الله  ايش  صاير  لشبابنا الحشيش  والمخدرات  غزههم الله  يهونها ويحفظ  شباب  وبنات  الاردن	Negative
 وانا  من  الناس  اللي  فعلا  محتاجين  يحاسبوا  نفسهم ويصلحو  من  نفسهم اننا عارفين  انه لا  ملجا  لنا الالا لالله	Positive
 الله  يثبتك ينور  طريقنا	Positive
 هاكدا  هو  دين  المحبه  الصحيح  بس  لالاسف  الكثيرين  يتبنواه حسب  ما  يشتهون	Positive
 ما  اسخفك	Negative
 صباح  الحريه  والنصر	Positive
 لو  نريد  الخشوع  حقا  نطلق  الدنيا	Positive
 هو  هذا  اسلامك يا  زاني	Negative
 للهم  خذهم اخد  عزيز  مقتدر  فانهم لا  يرحموا  الضعفاء  اللهم  سلط  عليهم عذابك فانهم ارونا  الويلات	Negative
 اسفل  من  بعضهم	Negative
 الانكسار  من  اسوء  الاشياء	Negative
 عظيم  هو  اسلامنا	Positive
 اللهم  لا  تكلنا الي  انفسنا طرفه عين	Positive
 اللهم  اني اسالك خشيه  في  السر  والعلن	Positive
 اللهم  اجعلنا  داءما  مسلمين  صادقين  في  افكارنا في  اعمالنا	Positive
 انشاء  الله  نكون  راضين  بقضاء  الله  لكننا نرجو  من  الله  اللطف  فيه	Positive
 المشكله  ناس  بتسمع  حالها بالحمام  هيه  وبتغني	Negative
 ودي  اكسر  الابتوب  علي  راسه	Negative
 سوبر  حمار  والله  هذا  السوبر  حما  سبب  في  تخلفنا	Negative
 الله  يهدي  الجميع  لالاسلام	Positive
 شو  بالالا يا  دانيا  المشكله  مش  عارفه تكتب  هعهعه	Negative
 قلولهم  هذا  سوبر  ستار  مش  مسابقه لبياع  الخضار	Negative
 علي  فكره المعلقين  هدول  ولاد  حرام	Negative
 والله  نحن  مو  ناقصنا  وجع  قلب  بس  ضايل  علينا النووي  و  صحه  البشر  مش  برضو  خطيه المسءولين  ?  خلص  ما  عاد  في  شي  فارق  والله  عحب	Negative
 والله  انك مهزله	Negative
 اموت  فيج  رويده	Negative
 والله  لو  طلبوا  مين  اللي  عندو  قلب  قوي  ?  ?  ?  متر  لالجري  مايتقدم  ولا  حمار  عربي	Negative
 عجبتني الحلقه	Positive
 جميله اوي  اوي  اوي  يارب  الكل  يحس  معني  الكلام  ده	Positive
 والله  مش  طبيعي  حرام  الله  غير  تنتشر  السرقه  النهب  خرب  الامان  النشور	Negative
 لا  تعليق	Negative
 يا  رب  ارزقنا  الفرح  والسعاده	Positive
 يلعن  شرف  خواتك	Negative
 لا  نووي  ولا  صوبه بواري كالعاده  نصبه جديده	Negative
 الله  لا  يشبعكو  يا  حراميه	Negative
 اموت  بصوهها	Negative
 كل  شء  ماله معني  بهالحياه  الا  الفلوس  هي  الحياه  وهي  من  تقرر  مصير  كل  شء  بهالدنيا  الا  شء  واحد  الموت  لا  يتناغم  مع  الفلوس	Positive
 والله  انك مسخره يا  عجوز	Negative
 اقسم  بالله  ان  العرب  اكثر  الشعوب  تخلفا	Negative
 الحب  بين  الزوجين  اوسع  ابواب  السعاده	Positive
 الفن  اصبح  هابط  هذه  الايام	Negative
 تم  تنفيذ  الحكم  الي  في  الرد  الاول  وتم  اعدام  اول  راس  والباقي  بالطريق	Negative
 وسدءيني  انكو  كلاب	Negative
 اه  ياشويه  عاهات	Negative
 صباحك طيب  كطيب  المسك  العنبر	Positive
 اللهم  اجعل  لنا ايمانا  صادقا  قلبا  خاشعا  علما  نافعا	Positive
 لعنكم الله  جهنم  وبءس  المصير  ايها  العازفون	Negative
 ايس  شراع  القرف	Negative
 ليهنا نستطيع  الابتسامه  في  الاوقات  المءلمه	Positive
 انته والمعك كلهم سافلين  ووقحين	Negative
 قمه التخلف  البشري  الله  يشفيهم	Negative
 والله  انكو  ما  بتخافوالله	Negative
 حرام  تحمل  اسم  عظيم  زي  هيك	Negative
 فيروسات  بشريه	Negative
 عالم  فاضيه  بيسمو  الغناء  فن  بيشغلو  الناس	Negative
 مالك  دين  مثل  الكلاب  الضاله  الالا اقولك مثل  مومسات  عاهرات  المراقص  عندكن	Negative
 الماء  اساس  الحياه	Positive
 تسلم  انت  وافكارك	Positive
 اللهم  اكرمنا برضاك	Positive
 ما  الزه شكله بشهي  بدي	Positive
 حفظ  الله  وطننا من  المنافقين  المتاردنين	Negative
 يا  سيدي هدول  عاهات  ولالله  يعني  فيك تسحب  عليهم قرض  من  البنك  كونهم عاهات	Negative
 صوته مره منبح  احسه تعبان  عاد  زبدوله  مابقي  الا  يطلع  بعد  شوي	Negative
 يا  رب  نستغفرك ونتوب  اليك يا  رب  ما  لنا سويك	Positive
 لا  تحزن  الدنيا  ما  فيها اشي  تحزن  عليه	Positive
 اهل  العقول  براحه ام  نسيانك يابو  نسيان  صعب  والله  صعب	Negative
 انا  بدات  اتحرك  شاركت  بفكره ستغير  الكثير  من  واقعن	Positive
 اللهم  ثبته علي  دين  الاسلام  اللهم  يا  مقلب  القلوب  ثبت  قلبي علي  دينك	Positive
 عنجد  انو  باله	Negative
 من  ترك  شيءا  لالله  عوضه الله  خيرا  منه	Positive
 هذه  رويدا  عطيه  يا  الخبوول	Negative
 حثاله  علي  حثاله  والحثاله  انظف  منهم	Negative
 كثر  الله  من  امثالك زادك الله  علم	Positive
 يعطيك العافيه	Positive
 اعنكم الله  تقبل  منكم يسر  طريقكم	Positive
 ان  المعلم  الذي  يسعي  لالتطوير  والاستزاده  هو  الاقدر  علي  غرس  الالتزام  والطموح  في  طلابه	Positive
 لعن  الله  المتشبهين  من  الرجال  لالنساء	Negative
 عندماما يقدم  طلاب  علي  حرق  الكتب  المدرسيه  والاضراب  فنحن  نعيش  انتكاسه في  التعليم  بطلها المعلم  الغير  مبالي  الذين  اججوا  وافتعلوا  الازمه	Negative
 انا  حاسه  انه قلبي مليان  وعامر  بنور  الله	Positive
 ارحمونا  صرنا نصف  السياره  نطلع  بالباص  حرام  عليكم	Negative
 اللهم  ارزقنا  كما  ترزق  البغاث  تسلميلي  هنوده حلواه كثير  الله  يفتح  عليكي  يهدينا اياكي	Positive
 فعلا  برنامج  ساقط  واللي  بيتابعه  اسقط  منه	Negative
 اللهم  استرنا  وجميع  بنات  المسلمين	Positive
 تقول  داخله فيها ترله انحولت  مع  الاغنيه	Negative
 كلمات  راءعه حلواه لا  احلي  ان  يكونو  في  النهايه  راءعون	Positive
 اصلا  ابو  وديع  لو  كان  اجا  كان  خسر	Negative
 نعم  احسنت  واجبه علي  كل  مسلم  وحق  لكل  مسلم  فتح  الله  عليكم	Positive
 والله  رفعتوا  راسنا يا  شباب  الله  يقويكم	Positive
 اللهم  انس  قلوبنا بذكرك	Positive
 ما  احقر  الاصدقاء  حينما  يصبحون  غرباء  فجاه	Negative
 يعني  دوله اللي  من  وين  جاي  كيف  وصل  عشان  تشوفه لجنه التحكيم  مبين  عليه مجنون  مش  شايف  اشي  قدامه	Negative
 امشي  عدل  يحتار  عدوك فيك	Positive
 بياعين  شرف	Negative
 اسعد  الله  صباحكم علامهنا بالخيرات	Positive
 صباح  الابتسامه  مرسومه علي  محياك ربي اجعل  حياهي حياه  احبهي نور  علي  نور	Positive
 الف  مبروك  تخرج  ابناء  الظفير  من  الكليه  العسكريه  الملكيه  من  الاردن	Positive
 بجد  موضوع  راءع  وانا  اجد  انه مناسب  ايضا  لهذا  الوقت  يارب  احفظنا من  جميع  الفتن	Positive
 ضيعت  دقايق  من  عمري  بمشاهده ازنخ  اتفه  شخص  بالحياه  الالا هو  اللي  بالنص  لا  حتي  بعرف  اسمه	Negative
 انسان  غريب	Negative
 متهور  وكذاب	Negative
 لبنان  وزبالتوا	Negative
" ""  كل  البدايات  جميله لكن  العبره  داءما  تكون  بالختام  ,  اما  كسبت  او  تعلمت  درس  مستحيل  تنساه .  """	Positive
 صح  الصح  كمان	Positive
 اجل  الاخير  واضح  انو  بيمثل  وتمثيلو  خام  هو  والا  معو	Negative
 نسعي  بكل  همه وجهد  لالحصول  علي  مصادر  طاقه رخيصه تعزز  من  اقتصاد  الاردن  كون  الطاقه  تشكل  ربع  موازنه الدوله	Positive
 اي  تفاءل  هاد  يا  زلمه روح  تشاءم  احسلك	Negative
 يا  خساره  عليكو  يا  شباب  المستقبل	Negative
 طيب  انا  عايزه  اشوف  القصر	Positive
 مجنون  صوتها انا	Negative
 سخافه مالها حدود	Negative
 اعطيه علي  راسي هدا  الصح  ياحاجه  الله  اكبر	Negative
 اللهم  اجعلنا  منمن تنظر  اليهم بحب  اشتياق  اجعلنا  من  عبادك التوابين  المخلصين  العابدين  الحق  لدينك احفظنا قنا  نار  وقودها الناس  الحجاره  يا  رب	Positive
 برنامج  ساقط	Negative
 سخيف  مره يمسخرون  الواحد  ومافي  شي  يضحك  اصلا	Negative
 الله  يلعنكم يا  اولاد  الحرام  الفن  له اهله وناسه لا  يحتاج  لا  مسابقه ولا  زبي  تفو	Negative
 انه غير  مسلم  ويعرف  قلبه الوفاء  فكيف  حال  المسلمين  اللهم  ارزق  بنات  المسلمين  زوجا  طيبا  محبا  مثله	Positive
 طيب  ليه السخريه  دي  ماكنا  كويسين	Negative
 يارب  وانت  ادعيلي	Positive
 صباح  الرحمه  و  البركات  ان  شاء  الله	Positive
 فعلا  ان  الطموح  هو  سر  النجاح	Positive
 الثقه  بالله  ثم  النفس  ويارب  اجعلنا  من  يغير  الناس  الي  ما  ترضيه	Positive
 ان  الله  هو  الرزاق  دو  القوه  المتين	Positive
 العرق  كل  شوي  يزيد	Negative
 ربنا  يقوينا ويقدرنا	Positive
 نعم  والحمد  لالله	Positive
 ليت  كل  ايام  السنه رمضان	Positive
 قال  حكم  قال	Negative
 والله  انك ما  زليه  يا  شيخ  اكيد  مدفوعله  من  تحت  تحت	Negative
 انا  متاكده  انو  هذولي  مدفوعلهم  علشان  يجون  يغنون  لانو  مافي  ناس  مهابيل  لهالدرجه	Negative
 القدوه  الحسنه  خير  من  النصيحه	Positive
 ربنا  يحمي  الاسلام  والمسلمين	Positive
 استاذ  غاوي  غاوي  اذا  كنت  غاوي  المسخره  روح  اشتغل  كراكوز	Negative
 هذا  انا  واغني  وانا  بالحمام  وانتوا  بكرامه صوتي  احلا  من  العاهات  هذيل	Negative
 وعجلت  اليك ربي  لترضي  :  كن  كالمطر  ,  اذا  اقبل  استبشر  الناس  به واذا  حط  نفعهم ,  واذا  رحل  ترك  اثرا  نافعا  فيهم واذا  غاب  اشتاقوا  اليه .	Positive
 طبيب  عيون  اردني  يسجل  اختراعا  جديدا  في  روسيا  .  كل  يوم  انجاز  اردني  يسجل  .  ا  لا  ردن  تكبر  بابناءها	Positive
 فانا  اناشد  الحكومه  الاردنيه  بالافراج  عن  اسري  السلفيين  التوحيدين  الموجودين  في  سجونهم	Negative
 اكبر  مشروع  طاقه شمسيه بالعالم  .  .  .  في  الاردن  اسمه شمس  معان  .  .  حفظ  الله  الاردن	Positive
 نفع  الله  بك  يا  دكتور	Positive
 حرف  الراء  مصيبه  ريس	Negative
 فعلا  الله  يبعدنا عن  الكذب	Positive
 نعم  في  البدايه  كلهم اروع  من  الروعه	Positive
 تغني  وهي  متقرفه	Negative
 ريحتك طلعت	Negative
 والله  حرام  الناس  مش  لاقيه توكل  حتي  ترفعو  البنزين	Negative
 الصادق  ينتظر  الفرج  ولا  يياس  من  روح  الله	Positive
 شو  هيدا  دلع  اخر  زمن	Negative
 بارك  الله  فيك انا  نضال  فدعولي  بزوجه صالحه	Positive
 انا  خليني  ساكته احسن	Negative
 حرام  عليك ماتشوفه  شلون  يصارخ  كانه مشجع  في  ملعب	Negative
 الحب  الحقيقي  عمله نادره فعلا  وهو  نعمه كبيره من  الله  عزوجل	Positive
 انا  عرف  شيء  والله  ببكي اكتر  ما  بضحك	Negative
 واذكر  ربك اذا  نسيت  وقل  عسي  ان  يهديني ربي  لاقرب  من  هذا  رشدا	Positive
 ايه  الاحساس  الراقي	Positive
 لالاسف  اصبحنا  غرباء  في  اوطاننا اصبح  الوطن  وكانه ليس  لنا اصبح  الوطن  ملك  خاص  لتاجرين  والمتنفذين	Negative
 رحمه الله  رحمه واسعه واسكنه فسيح  جناته .  .  نعم  الدكتور  ونعم  الداعيه  ونعم  الاب  ونعم  الصديق  .  .  .  .  مخلص  في  عمله .  .  .  صدوق  في  دعوهه	Positive
 ان  النجاح  يحتاج  الي  قلبا  ثابت  عقلا  راشد  طموحا  واعد  تحدي  كاسر	Positive
 كلو  حكي فاضي	Negative
 تليفيزيون  المستقبل  صار  سيء  لالغايه  ما  ادري  ليش	Negative
 الدعوه  مش  بالكلام  بس  ممكن  نكون  دعاه  باخلاقنا اسلوبنا تعاملنا	Positive
 يخرب  الدلع	Negative
 لالاسف  لسا  في  مدارس  بتخلخل  عظام  الطلاب  من  البرد  عن  مدارس  قري  الاردن  و  المناطق  الشعبيه  عم  بحكي	Negative
 قهرواني حرام	Negative
 كرامهي افضل  من  سعادهي	Positive
 لا  لالمفاعل  داخل  الاردن	Negative
 خت  قرار  كتير  وبرجع  تاني  بحاول  اتغير  ومش  عرفه	Positive
 واعظمها امه سيدنا محمد	Positive
 ابو  معيتق  قطع  اوتار  العود  وقال  السلام  عليكم	Negative
 وش  جابني هنا  ثقيلين  دم	Negative
 اللهم  ارنا فيهم عجيب  صنعك فانهم اذلو  الشعوب	Negative
 نعم  مصر  عايزه  راجل  مش  واحد  وسخ  بيقرف	Negative
 شو  نوع  الحشيش  ?  ?	Negative
 هي  فلسطين  راحت  من  قليل  يا  ولاد  المخنثه  لعنه الله  عليكم فظحتونا	Negative
 لا  عنجد  زلمه شكلو  بخوف	Negative
 حلواه قوي  يا  عمرو  لو  كل  واحد  تيقن  من  هذه  القصه  لن  يوجد  حاسد  لا  ظالم  لا  متواكل  اللهم  ارزقنا  رزقا  حلال  طيبا  اللهم  امين	Positive
 هذا  اللي  انت  فالح  فيه بس  كيف  تختار  ضحاياك بالسرق  جعل  العاهه  تصيبك ولاعاد  تطيب  منها ياولد  الحرام	Negative
 ما  انا  شطبت	Negative
 مين  معو  دوا  لالصراصير  جد  لازمهم رش  مبيد  حشري  لالقضاء  علي  هيك  حالات  متخلفه	Negative
 الراءع  سيظل  راءعا  حتي  نهايه  العمر	Positive
 الله  يرفعهم الي  جهنم  جنب  القذافي  باسرع  وقت  لان  الظلم  زاد  عن  حده	Negative
 قمه التخلف  والانحطاط	Negative
 ربنا  اجعلنا  من  الصالحين  اهدنا  الي  الريق  المستقيم	Positive
 في  كل  مناحي  الحياه  التكنولوجيا  بديل  عن  البشر  الا  في  التعليم  التكنولوجيا  تجعل  عمل  المعلم  .  .  متعه لا  بديلا  عنه	Positive
 صوتك وحش	Negative
 مستحيل  اثق  بذوق  حدا  ما  بحب  يسمع  لام  كلثوم	Negative
 الله  يهدي  النفوس  ربي  ابعث  لنا في  هذا  اليوم  فرح  يغير  ايامنا وينعش  قلوبنا من  جديد	Positive
 شكرا  دكتور  فكلماتك لها بالغ  الاثر  في  نفوسنا	Positive
 صوتها بعير  ومصدقه حالها	Negative
 انت  يا  دكتور  خير  اخ  ربنا يزور  عليك	Positive
 صباح  الورد  الجوري  الحمر  والخمري	Positive
 انا  مع  الاخ  محمد  سلامه  بهالموضوع	Negative
 يسعد  صباحك بذكر  الرحمن	Positive
 ما  احلي  الوجود  بقرب  الله	Positive
 اطفال  اليوم  رجال  الغد  ومستقبل  الامه	Positive
 دعواه المءمن  لاخه بظهر  الغيب  اسرع  من  البرق	Positive
 ربنا  يباركلك  يا  استاذي يعزك	Positive
 ما  اضيق  العيش  لولا  فسحه الامل  الحمد  لالله	Positive
 شكرا  لجميل  اثراءك المعرفي  ,  كلامك وسلاسهك في  ايصال  المعلومه  جميله لالغايه	Positive
 اقرفني  شعر  تقول  حاط  دبر  امل  وجاي	Negative
 انا  دايما  فرحان  مش  ساءل  بالدنيا  الحمد  لالله	Positive
 ربما  تنام  وعشرات  الدعوات  ترفع  لك ,  من  فقير  اعنهه او  جاءع  اطعمهه ,  او  حزين  اسعدته اومكروب  نفست  عنه ,  فلا  تستهن  بفعل  الخير	Positive
 اساس  الاصلاح  واهم  مرتكزاته المعلم  داخل  غرفه الصف  مع  طلابه وتلاميذه والاعتماد  عليه بالتنفيذ  لخطط  واستراتيجيات  عليا	Positive
 الجمال  :  ليس  فقط  شيءا  نراه بل  هو  شيء  نكتشفه ,  روح  جميله ,  وفكر  جميل  ,  اخلاق  جميله ,  وادب  جميل	Positive
 ده  عمله نادره  الاخلاق  ملهاش  علاقه بالدين	Positive
 يا  طيب  صباحك كل  خيرات	Positive
 ماكرمك  يا  ربي يا  كريم	Positive
 صدقت  والله  انت  تريد  وانا  اريد  والله  يفعل  ما  يريد	Positive
 سبحانك ربنا الواحد  الاحد  لا  شريك  لك تحيي  تميت  انت  علي  كل  شيء  قدير  صلي  الله  سلم  علي  نبينا محمد  علي  اله  صحبه  اجمعين	Positive
 تابعت  هذا  الجوال  من  بدايه صدوره وقبل  اقترابه لالعالم  العربي  فعلا  يستحق  كل  هذه  الاهميه	Negative
 في  ايه  يا  ولاد  الوثخه  ?	Negative
 عليكم بالدعاء  والتضرع  لالله  سبحانه وتعالي  ولا  يرد  القضاء  اللا  الدعاء  اجتهدوا  رحمكم الله	Positive
 جمال  الصفحه  من  جمالكم رقي  اخلاقكم انا  متاكد  ان  صفحهنا ستعجبك فانضم  الينا ادعو  @@اصدقاءك@@ك فنحن  نسعد  بك  بهم	Positive
 اكيد  بقرف	Negative
 فعلا  اللي  بيستحوا  ماتوا	Negative
 غبي  من  جده	Negative
 صبحكم الله  ياهل  الطيب  بالخير  يسعد  ضحيكم الظهر  العشيه	Positive
 قول  يا  رب  وخد  قرار	Positive
 استخفف  من  لجنه التحكيم	Negative
 كلام  حلو  ومشجع	Positive
 اقسم  بالله  قرف  المريض  نفسيا  لالابد  يبقي  مريض  نفسيا	Negative
 ليش  تتضحكو  مش  حلو	Negative
 و  هكذا  جنت  علي  نفسها براقش	Negative
 اللهم  اصلح  حالي  احفظني نور  قلبي اجعل  طريق  الخير  طريقي اجعل  عملي خالصا  لوجهك الكريم  توب  علي  اغفر  لي زلاتي	Positive
 هنا  نجد  اصحاب  السوء  يحضرون  بقوه  لان  ها  هءلاء  لم  يحظروالي  بعد  تشجيع  من  اناس  حولهم	Negative
 كل  واحد  حرامي  ما  بهمو  مصلحه المسكين  المواطن  الي  بشتغل  14  ساعه  6  دنانير	Negative
 مافي  اجمل  من  قوله يارب  ومن  يتجه  الي  الله  عز  وجل  لن  يتركه الله  ابدا	Positive
 يا  فضيحهك يا  لبنان  بهيك عالم  اما  هيدا  سكت  اني ولك دخيل  الله  خليك  ساكت	Negative
 كتكوت  ضعيف  الجناح  الدنيا  غدرت  ها	Negative
 صباح  كل  جميل  في  هذا  الكون	Positive
 نهارك اسود	Negative
 فهم  ادري  واخبر  لا  وبل  اكثر  انكارا  لالشيعه  وامثالهم	Negative
 كن  انت  ذلك  الشخص	Positive
 والله  علي  بالي مجنون	Negative
 سلام  عليكم طبتم  تقال  لالطيبين  عندماما يساقون  للجنه وهم  من  طابت  اقوالهم وافعالهم في  الدنيا  .  اللهم  اجعلنا  منهم .  .	Positive
 يارب  يتقبل  مننا والله  العقل  مو  فاضي  والقلب  مكسور	Positive
 وماذا  عن  التفاءل  في  يوم  ربيعي جميل  نحقق  به الامال  الطوال	Positive
 الحمدلله  الذي  هدينا لهذا  وما  كنا  لنهتدي  لو  لا  ان  هدينا الله  .  لا  اله  ا  لا  الله  محمد  رسول  الله	Positive
 اصلا  سوبر  ستار  لالعاهات	Negative
 الحمد  لالله  الذي  رزقني بالاسلام	Positive
 يا  رب  اسعد  قلبي و  قرب  لي الخير	Positive
 عاهات  وعهد  الله  عاهات  ايه  اللي  خليهم يغنو  دول	Negative
 المعني  الحقيقي  لعاهاتك يا  وطن	Negative
 هذه  جزاء  كل  من  يتطاول  علي  رجال  هذه  الوطن  العزيز	Positive
 تسلم  صرمايهك	Negative
 الدين  عباره  عن  اخلاق  وحسن  التعامل  مع  الناس  وتهذيب  النفس  قبل  ما  يكون  مجموعه من  العبادات  !	Positive
 واحد  واطي	Negative
 اسال  الله  لك الاخلاص  يا  حبيبنا و  اشتاق  والله  لالصلاه  معكم واسال  الكريم  ان  يعيدكم الي  منبركم كل  عام  وانت  في  خير  وبخير	Positive
 وجهك مش  الك	Negative
 الله  ينتقم  منه حمزه منصور  واعوانه حسبنا الله  فيهم	Negative
 بقطعكم شو  حقودين	Negative
 صباحات  الانوار	Positive
 مالكيش  ف  الطيب  نصيب	Negative
 اللهم  ارزقنا  الصدق  الاخلاص	Positive
 للهم  اعنا  علي  ادراك  هذا  المعني  العظيم  يا  رب	Positive
 مايستحون	Negative
 اعلن  الانسحاب  يا  حمار	Negative
 يعني  ما  اختار  الا  الاغنيه  اللي  اغلب  احرفها الحرف  اللي  يقرط  فيه	Negative
 متخافش  يامءمن  قول  يارب  وحب  ربك ده  هو  اللي  خلق  النعمه  اللي  انت  متعلق  بيها  يعني  هو  اعظم  من  النعمه  دي  وانت  عارف  كده	Positive
 المشكله  في  ناس  تقنع  حالها انه جورج  وسوف  له علاقه بالاغاني	Negative
 لسانك قذر  يا  قمامه	Negative
 عرب  اغبياء	Negative
 اللهم  ارزقنا  السلامه  العافيه  في  ديننا دنيانا	Positive
 ما  ازنخك  انت  مقالاتك	Negative
 لان  ديانا  كرزون  البغله  الاردنيه  لا  تستحق  ذلك	Negative
 اصبحنا  اصبح  الملك  لالله  اللهم  لك الحمد  احييتنا بعد  ما  متنا  اليك النشور	Positive
 يارب  انت  المستعان  فاعنا  واهدنا  يارب  الكون  اجمع  استجب	Positive
 فعلا  ده  صحي  ح  مثلا  زي  سماع  الاغاني  التي  تلهي  عن  زكر  الله  لو  تركتها لالله  يملا  الله  قلبك بحبه ولاتشغل  بالك الالا بذكره	Positive
 عفكره  البيج  هاد  قرفني وقلب  معدهي شو  لالاسف  انتا  انو  عرفك انه هيك  الوضع  بتفتح  بالفنجان  يا  ناس  خفوا  علينا الدين  مش  للايكات  وكمنتات	Negative
 ربنا لا  تزغ  قلوبنا بعد  ان  هديتنا	Positive
 اقطع  راسها وخلص	Negative
 عليك بتقوي  الله  ان  كنت  غافلا	Positive
 رهيب  حسن  تعالي  تعالي	Negative
 هذه  مشكله الذي  يغني  كثيرا  في  الحمام  ويتصور  انه اصبح  مطرب	Negative
 ساترك حبك ليس  كرها  فيك ولكن  لكثره الشركاء  فيه	Positive
 الله  يسعد  كل  البشر  امين  يا  رب	Positive
 الجيل  الي  هيحرر  فلسطين  شوفه  في  سوريا  يقاتل  العلويين  الكلاب  لكن  ربي  يعلمهم فنون  القتال  ويربيهم	Negative
 الحمد  لالله  نامل  من  الله  ان  يمن  علينا بالهدايه	Positive
 ان  الله  علي  كل  شيء  قدير	Positive
 يع  حاسه  حالي  بدي استفرغ	Negative
 انا  مش  مسءول  عن  الحراميه  يتفنجرو  بمصاري  البلد  انا  اشحد	Negative
 معظم  اصحاب  محطات  الوقود  وكالات  الغاز  متنفذين  لقد  زاد  الغني  غني  الفقير  فقر	Negative
 بعدين  الاردن  تسبح  علي  بحر  من  النفط  الصخر  الزيتي  اشتغلو  فيه بالاول  بيكفينا  100  سنه	Negative
 موضوع  اكتر  من  راءع	Positive
 يارب  اخرجنا  من  ذل  المعصيه  الي  عز  الطاعه	Positive
 اللهم  اغفر  لي لامه المسلمين  اجمعين	Positive
 بلا  هم  بلا  وجع  راس  خليك  رايق  دايما	Positive
 نسمات  انتعاش  الفجر  رحمات  يظفر  بها اهل  النور  التام  الذين  توسعت  صدورهم بانشراح  جماعه الفجر  حيويه  صبح  يتنفس  منتشيا  مرحبا  بكل  مبادر  لالخير	Positive
 بكره واحد  منهم بينتحر  لم  يضحكو  عليه	Negative
 اصلا  هدا  يمسي  مرض  الرهاب  الاجتماعي	Negative
 اصلن  صاحب  البرنامج  ماخذ  شباب  الامه  مصخره	Negative
 لا  والله  ما  بلسه  يع	Negative
 يارب  يقوينا جميعا  علي  طاعهه وحسن  عبادهه	Positive
 كلام  ما  في  جدل	Positive
 الاردن  تعدل  المناهج  :  تقليصا  في  الاستشهاد  بايات  قرانيه واحاديث  نبويه  ,  وبدلا  من  ذلك  تم  اعتماد  دروس  اقرب  الي  اخلاق  الحياه  اليوميه  لالطالب	Negative
 انماما المءمنون  اخوه فاصلحو  ذات  البين	Positive
 دربي زدني  ثقتا  بك  فانه لايخيب  من  وثق  بك	Positive
 شعور  الانفصام  تاع  سنه خامسه كثير  بخزي  !  اللي  هو  انك عملت  كل  شي  ممكن  ينعمل  بالجامعه  فزهقت  وبدك تتخرج  بس  بنفس  الوقت  مش  هاين  عليك تترك  الجامعه	Negative
 ولا  بقلو  بيضه	Negative
 انت  واحد  عنجد  قليل  ادب  الله  يموت  الي  امثالك	Negative
 الله  اكبر  ما  من  دابتن  الا  علي  الله  رزقه	Positive
 والله  احلا  شيء  انه الواحد  يهاجر  او  يشتغل  حرامي  عشان  يقدر  يعيش  الله  لا  يوفق  الي  كان  السبب  الله  حرام	Negative
 حظ  من  ينعم  بمحبه الصغار  قبل  الكبار  ,  لان  محبههم صادقه ومن  القلب	Positive
 بارك  الله  في  كاتبها	Positive
 ربي  اشرح  لي صدري  و  احلل  عقده من  لساني	Positive
 انتخب  مين  يا  عم  هي  ناقصه لبخه في  الكلام  معتش  الا  الاهبل  ده  كمان  يبقي  رءيس  جمهوريه	Negative
 وهاي  المضروبه  جايخه  علي  وين	Negative
 الله  يكون  في  عون  الفقير  الطبقه  المتوسط  سوف  تنحدر  اكثر  اكثر	Negative
 الحمد  لالله  اصبح  علي  وجهك المشرق  كل  يوم	Positive
 اللهم  ثبت  قلوبنا علي  الايمان	Positive
 حلمي  ان  اكون  مثل  سوشي	Positive
 الله  اكرم  الاكرمين  اللهم  اعنا  علي  انفسنا واللهم  ارضي  عنك يارب  العالمين	Positive
 يعني  كل  جامعات  الاردن  عندهم نظام  ,  و  احنا عننا خرا	Negative
 ما  اجمل  من  مثل  هذا  الحب  الصادق  الشفا	Negative
 الله  حيك شيخ  ابراهيم  بالفعل  حكم  يا  نشمي	Negative
 اهم  اشي  اكون  مبسوط	Positive
 حينما  ننجح  في  الانتصار  علي  انفسنا	Positive
 الله  يكتر  من  امثالك يارب	Positive
 روح  موت  وانتحر	Negative
 اللهم  امليء  قلبي بحبك	Positive
 حالات  مرضيه نفسيه مستعصياه لا  يستطيع  شفاءها لا  العلم  لا  الفن	Negative
 تءلمني باسم  الحب	Negative
 اللهم  اكفني  بحلالك عن  حرامك واغنني بفضلك عمنمن سويك يا  رب	Positive
 ساعات  اللي  في  السر  هو  اللي  بيخلي  الناس  تحبك  في  العلن  من  غير  ما  يكونوا  عارفين  الا  انهم بيحبوك  من  غير  سبب	Positive
 فيديو  بايخ	Negative
 والشرهه  علي  الاغبياء  اللي  معطينك  لايك	Negative
 هذول  مجانين  اكيد  ما  بوافق  مش  هبله انا	Negative
 روح  اكتب  اشي  زي  العالم  الناس  بدل  ما  انت  بتتهبل  هيك  بتتمسخر  يا  مسخره	Negative
 فعلا  فضايح  ما  توقعتها في  شبابنا المتخلف  اخلاقيا  وصوتيا  وبدنيا  اها  وعقليا  بالتاكيد	Negative
 صلوا  علي  من  بكي  شوقا  لرءيهنا	Positive
 عيب  عليكوا  تقارنوا  وحده زي  دي  بالمصحف  الي  هوا  كلام  ربنا	Negative
 الظاهر  اهلها مفقعين  وجهها قبل  ما  تجي  ومغطيه الفلعات	Negative
 يارب  طهر  قلوبنا يارب  اهدينا  لالصواب	Positive
 مساكين  ها  البشر	Negative
 قرف  شوهاد  شي  بخزي  عنجد	Negative
 عادي  محنا  اتعودنا  علي  الرفع  من  يوم  يومنا نحن  ما  بنعرف  غير  الرفع  همه برفعو  نحنا  بندفع  علي  حسابنا	Negative
 كلب  وحقير	Negative
 اللهم  ارزقنا  من  خيري  الدنيا  الاخره  ارزقنا  حسن  الخاتمه  ارزقنا  الفردوس  الاعلي  مع  من  نحب  ارزقنا  لذه النظر  الي  وجهك الكريم	Positive
 ستضافتهم  وعاملههم معامله انسانيه ولم  تحصرهم في  مخيمات  تفتقر  لادني  مطلوبات  الحياه  مثل  الاردن	Positive
 مش  عارف  كيف  الناس  بتحبك  يا  زلمه ?	Negative
 قولي  يارب  ثم  توكلي  عليه انه نعم  المولي  نعم  الوكيل  احتسبي  عنده ما  تظنين  انك لا  تقدرين  عليه	Positive
 نعم  اردنا  غير  قابل  لالتلاعب  بارواح  ابناءه	Negative
 اللهم  انزع  من  قلبي حب  كل  شيء  لا  تحبه	Positive
 شي  مءكد  انك حمار	Negative
 بارك  الله  فيك نتمني  المزيد  من  النصاءح	Positive
 لست  الافضل  لكن  لي اسلوبي  ساظل  داءما  اتقبل  راي  الناقد  الحاسد	Positive
 انا  لاحظت  اللبنانيين  انهم ماعندهم  روح  الكوميديا  نهاءيا	Negative
 بالله  عليكم الم  تستحيوا  من  انفسكم قبل  قدومكم الي  هذا  البرنامج  ثم  الم  تعلموا  ان  هناك  مسابقات  لانكر  الاصوات  في  قناه  اخري	Negative
 تكالبت  عليه الكلاب  ولم  تسمح  له بالبروز  بعد  البرنامج	Negative
 قرف  يقرف  اللبنانيين  شو  تافهين	Negative
 انتي  عنجد  بنت  فاشله	Negative
 لجنه تافهه	Negative
 لو  يطلع  عليهم بفضحو  عرضهم كلهم	Negative
 لا  يوجد  كفاءات  بالاردن  قادره  علي  اداره  هكذا  مشروع	Negative
 اللهم  ارزقنا  العمل  الصالح  الذريه  الصالحه  ارزقنا  يا  الله  حسن  الخاتمه	Positive
 لا  تحزن  علي  دنا  فانيه  بل  احزن  علي  اخره باقيه	Positive
 سبحان  الله  بحمده عدد  خلقه رضي  نفسه زنه عرشه مداد  كلماته	Positive
 صباح  مملوء  بالخير  لجميع  المسلمين  يا  رب	Positive
 ما  شاء  الله  الله  يثبتك	Positive
 صادقه وفنانه  من  الزمن  الجميل  والفن  اخلاق  واحساسها يدرس	Positive
 يخسو  الشيعه  الخنزير	Negative
 لا  محاله اول  شيء  يحدث  له بعد  عودهه لالمغرب  سيتم  اغتصابه كالعاهره	Negative
 يا  عني علي  ذكرك شكرك حسن  عبادهك	Positive
 اترك  ما  تهوي  لاجل  من  تخشي	Positive
 لا  تحزن  ان  الله  معك	Positive
 فدمك عود  مع  عنبر	Positive
 احيانا  الوحده  تزيل  بعضا  من  الهموم	Positive
 والغناء  تجد  لك ?  ?  ?  مليون  وكلهم زباله	Negative
 والله  ما  يحرر  عزبت  بنقاليه	Negative
 نعم  الصديق  الوفي	Positive
 فاشله من  بيءه  فاشله	Negative
 ليش  الطلاب  فاضين  يعملو  مشاكل  فاضين  لالدراسه  يعني  ما  عندهم وقت  فراغ  لالمشاكل	Negative
 يارب  ساعدني وقويني  وساعدني اخد  حبيبي	Positive
 استاذ  عمرو  يا  ريت  شويه  تركيز  علي  اخوهنا في  بورما  انهم يتعرضوا  لحرب  حقيقيه	Positive
 عنجد  الكذب  اكبر  ورطه	Positive
 جزمهي الالا اقولك اسفل  جزمهي الثوره  في  سوريا  ما  اشعلها الا  الوهابيين  اللي  هم  السلفيين	Negative
 سابقي  راءعا  معك الي  النهايه  ان  بقيهي راءعه معي  الي  النهايه	Positive
 دعواتك لنا يا  شيخ  سلمان  بالتوفيق  الفلاح  الظفر  حسن  الخاتمه	Positive
 ونعم  بالله  العلي  العظيم  ونعم  بالله  عزوجل	Positive
 من  الي  ضاحك  عليهم انو  اصواتهم حلواه	Negative
 عين  العقل  ربي	Positive
 اللهم  اني استغفرك من  كل  الذنوب  والمعاصي  واتوب  اليك	Positive
 الله  يتمم  افراح  الجميع  يا  رب	Positive
 ايه  راحه فيها المسكين  ياحرام	Negative
 خساره  فيك اسمك :	Negative
 يا  حبيبي  هاي  صار  لالرجال  تنانير  ?  تفي  هيك  رجاله	Negative
 ليس  هناك  شخص  معاق  بل  هناك  مجتمع  يعيق	Negative
 بعض  الاصدقاء  يشبهون  المطر  في  قدرههم علي  تعديل  المزاج  هءلاء  من  احتاجهم بقربي	Positive
 صح  الابتسامه  تصنع  السعاده	Positive
 بلد  يديرها اغبياء  حراميه	Negative
 ربنا  يوفق  الجميع  علي  الخشوع	Positive
 والله  انو  مكب  نفايات  نوويه  انا  اشتغلت  بالمفاعل  موقعه بعلان  بالسلط	Negative
 المنتخب  الايطالي  عقيم  هجوميا  بعد  ماكان  منتخب  يخشي  هجومه كل  المنتخبات	Negative
 اللهم  اهدنا  الي  صراطتك  المستقيم	Positive
 الله  اكبر  ولالله  الحمد  مصر  بخير  فيها ناس  كتير  طيبين	Positive
 حاويه زباله بوجهك	Negative
 اللهم  اني اعود  بك  من  الذنوب  التي  تزيل  نعمهك وتحول  عافيهك وتحبس  رزقك وتعجل  بغضبك	Positive
 عرب  جرب	Negative
 شفتها اقول  وشذا  الكيك	Negative
 والله  حرام  تكاليف  زواج  ومهر  واخرهها طلاق  بسبب  شي  تافهه	Negative
 تيس  مابفهم	Negative
 صباح  الدرب  للجنه	Positive
 محششين  خ	Negative
 صباح  الخير  الاشراق  الامل	Positive
 قرد  زاني  ابن  حرام  انقلع  قبح  الله  صورهك ياخنزير	Negative
 الظاهر  انه جايين  يستهبلون  عالحكام  بس	Negative
 لو  طلعهي من  الاردن  وين  تروحي	Negative
 الحمدلله  علي  السلامه  وماتشوف  شر  .  .  طهور  وقدامك العافيه  ان  شاء  الله	Positive
 وعرض  اختي  انك لاسع  يادمن  عساس  لو  بدها تضرب  من  هسه خايفه  منك	Negative
 اكبر  مشكله تواجهكك  في  الاردن  ;  اذا  طلعت  من  الدار  شبعان  ,  بتعرفش  وين  تروح	Negative
 هذا  عدا  عن  عنصريهكم البغيضه  وجلافتكم  وعنجهيهكم الفارغه  مع  بقيه الشعوب	Negative
 يا  مقلب  القلوب  ثبت  قلوبنا علي  الاسلام	Positive
 ضحكت  طفل  بسمه امل	Positive
 حفظ  الله  ابناء  وبنات  الامه جميع	Positive
 اللهم  ثبتنا  علي  قيام  الليل  في  رمضان	Positive
 صور  جميله	Positive
 وش  فيك معصب  خلاص  بعطيك  اللايك  الي  جاني  خ	Negative
 اللهم  القلوب  الضاله	Positive
 حسبنا الله  نعم  الوكيل  فيكم في  مجلس  النواب  الحالي  الذي  لا  يمثل  الشعب  الاردني  فهم  غير  ساءلين  عن  الشعب  يبحثون  عن  مناصب  وزاريه  رواتب  خياليه بينما  المواطن  الاردني  طفح  الكيل  معه اصبح  لا  يطيق  الحياه	Negative
 ان  الدين  عند  الله  الاسلام  هذا  هو  الدين  الذي  يجب  ان  يعتنقه كل  انسان  علي  وجه  الارض  وليس  العرب  فقط  اللهم  اهدي  غير  المسلمين  الي  دين  الاسلام	Positive
 ه  انا  من  ناحيتي  هاظ  الانسان  الي  قاعد  بلنص  اقرف  واحد	Negative
 قصه راءعه  ياريت  كل  الرجال  هيك	Positive
 لما  تكثر  عليا  الالتزامات  يصير  كل  اللي  نفسي اسويه استلقي  علي  ظهري  واسولف  لالسماء	Negative
 واثق  من  نفسه الحبيب	Negative
 لا  ياس  مع  الحياه	Positive
 الاردن  كثير  حلواه من  كل  النواحي  .  .  طبيعه  و  معالم  و  اثار	Positive
 جامعه العلوم  والتكنولوجيا  الاردنيه  افضل  من  92.7  %  من  جامعات  العالم  و  98.2  %  من  جامعات  الوطن  العربي  طبقا  لتصنيف  ويب	Positive
 والله  انا  خايف  انو  طخوا  بعد  هاي  الصوره	Negative
 الله  يثبته يا  رب  ويثبتنا نحن  كمان	Positive
 قصدك اخر  ما  توصل  اليه العقل  البشري  من  تفاهات	Negative
 خبر  عاجل  يمنع  لجميع  المجانين  التقدم  الي  سوبر  ستار	Negative
 اللي  لازم  يصير  اضراب  جميع  موظفي  الدواءر  الحكوميه  الخاصه  لمده اسبوع  شوف  بعدها	Negative
 فاهجر  تجد  عوضا  عنما تفارقه	Positive
 لا  تقنتوا  من  رحمه الله  فهي  وسعت  كل  شيء  مهما  عصينا  فلنا رب  كبير  رحيم  ورحمن	Positive
 هذا  معوق  جنه جورج  وسوف	Negative
 حيوان  وكلب  الله  يموتك	Negative
 اكثر  بني  ادم  يعاني  في  الحياه  هو  المغترب  بين  الاردن  والسعوديه  لا  اللي  هنا  فاهين  عليه ولا  اللي  هناك  والكل  ما  بحبو	Negative
 الحمد  لالله  رب  العالمين  علي  عطاه رضا	Positive
 ان  من  صفات  الاسلام  الامانه	Positive
 وادم  علينا يارب  نعمه الامن  والامان  وساءر  بلاد  المسلمين	Negative
 نار  جهنم  تاخدو	Negative
 يا  رب  خد  بيدنا يا  جبرنا يا  جبار  السموات  والارض	Positive
 الحمد  لالله  الحمد  لالله  الحمد  لالله  حمدا  شاكرا  ففضلك ربي	Positive
 ماخاب  من  دعا  الي  الله	Positive
 الله  يوفقكم والله  يجعلكم تفوزون  كلكم معنا قولوا  امين	Positive
 التفاءل  حلو  في  الحياه  بس  الاهم  تكون  عايش  مع  ناس  متفاءلين  مش  تكون  لحالك المتفاءل	Positive
 احسنت  كلام  دقيق  جدا	Positive
 المومين  الي  بعضهم كالبناء  الزي  يشد  بعضه البعض	Positive
 الوفاء  فيي غير  قلبك ما  لقيت	Positive
 سبحانك ربي  اني كنت  من  الضالمين	Positive
 الله  يا  ريت  كنا  في  ذاك  الزمن	Positive
 قريبا  ان  شاء  لالله  تسمع  اخبار  تسركم	Positive
 خبل  معوق	Negative
 اللهم  ارزقنا  الاخلاص  في  القول  العمل  في  السر  العلن  في  الرخاء  الشده  في  العافيه  المرض  عند  الابتلاء	Positive
 كلماتك عذبه	Positive
 والله  نفسي بس  الواحد  بيجي  عليه فترات  ينسي  يعمل  ايه  بجد	Positive
 اللهم  اعنا  علي  ذكرك وشكرك وحسن  عبادهك	Positive
 اوسخ  شي  المناديل	Negative
 ن  مقابله جلاله الملك  عبدالله  مع  قناه  سي  بي  اس  الاميركيه  .  يءرقني تامين  فرص  الحياه  الكريمه  لشباب  الاردن  و  لن  نسمح  لالارهاب  بالعبث  في  الاردن	Negative
 حلمي  اكون  ممثله افلام  دعاره	Negative
 يلعن  ام  الازعاج	Negative
 هذه  البرامج  اللي  تخلف  العاهات  لالفن  الهابط  فن  اليومين  هذا	Negative
 الحمد  لالله  علي  نعمه التي  لا  تحصي  الحمد  لالله  الذي  تكفل  برزقي الحمد  لالله  انه رب  يستحق  الحمد  علي  السراء  الضراء	Positive
 جزيك الله  كل  خير  دكتور  عمرو  ربنا يتقبل  مننا منكم ساءر  الاعمال	Positive
 بنحاول  في  كل  مره نكون  افضل	Positive
 الحمد  لالله  الذي  لا  يحمد  علي  مكره سويه	Positive
 فعلا  مهزله	Negative
 لان  ما  بعتقد  انو  في  هالقد  عاهات  ما  بيعرفوا  انو  صوتهم نشاز  لانو  كتيير  نشاز  وازا  في  رح  تكون  حالات  استثناءيه مو  بهاد  الكم  الكبير	Negative
 يازم  والله  ماعندكم  غير  الكذب  ع  الناس	Negative
 اللهم  اهدنا  ثم  ثبتنا	Positive
 احيانا  يكون  الفشل  دافع  لالنجاح	Positive
 فقد  عجزت  الكلمات	Negative
 سبحانه يهدي  من  يشاء  لا  اله  الا  الله  محمد  رسول  الله	Positive
 ربنا  يقوي  ايمانك	Positive
 بس  مقزز	Negative
 هي  عندها صوت  قوي  بس  لالاسف  الحين  مثل  غيرها	Negative
 يجيز  ارضاع  شرق  اسيا  كلها لكن  قياده المراه  لالسياره  فسق  وفجور	Negative
 مزعج  الي  كثير	Negative
 يارب  اغفر  لي ذنبي  وارزقني  حبك هو  ربنا ممكن  يكره  حد  لو  فضل  يكرر  ذنبه بعد  الاستغفار	Positive
 اظن  انهم حبو  وانجرحوا  وضاعت  عقولهم وما  دخل  قلوبهم الا  اغاني  الجروح  عشان  كذا  حافظينها  وجايين  يقولونها اللهم  لاشماته	Negative
 شباب  صايع  مو  ملاقي  ياكل  مخه فاضي  متخلف  عقليا	Negative
 من  ضحك  عليك وحكالك  صوتك حلو	Negative
 ما  فيها شك	Positive
 ياخي  برنامج  سامج  ساذج	Negative
 صباحكم امل  مشرق  عطا  متجدد  كما  شروق  الشمس	Positive
 امين  يا  رب  انت  شاب  زي  الفل  ما  شاء  الله  عليك	Positive
 الك يوم  يا  ظالم	Negative
 الله  علي  دينا  العظيم	Positive
 مبارك  الفوز	Positive
 ونعم  بالله  من  اختار  قرب  الله  فما  خاب  ابدا  الله  علي  دي  راحه وده شعور  الحمد  لل	Positive
 العالم  العربي  مليان  عاهات	Negative
 يا  رب  رضينا امنا صدقنا فارضينا برضاك عننا اجبر  كسر  قلوبنا هون  علينا	Positive
 من  اهم  مشاكل  التعليم  الجامعي  في  الجامعات  الرسميه  الاردن  ,  مشكله الاعداد  حيث  ان  كل  جامعه متجاوزه السقف  الاستيعابي  لها بالاف  الطلاب	Negative
 والله  الناس  دي  ما  شايله  هم  ابدا  علشان  كده مسخرو  نفسهم او  كرامههم راحت	Negative
 نهايه  مواطن  طفران	Negative
 هو  نحن  خلينا نخلص  ام  هالبرجين  اللي  صرلهم  16  سنه بعدين  بنفكر  نعمل  نووي  سلمي  من  الديسي	Negative
 انته جميل  جدا  ربنا يثبتك واتمني  ان  كل  المسلمين  تكون  اخلاقياتهم في  حياههم العاديه  قدوه ودعواه لكل  غير  المسلمين	Positive
 انت  ما  شفت  النسخه  الاوروبيه  والامريكيه  والماليزيه  من  نفس  البرنامج  فيها بلاوي  اكثر  من  كذا  بس  حنا  العرب  فينا عقده النقص  والتخلف	Negative
 مفيش  اكرم  ولا  ارحم  من  ربنا	Positive
 اللهم  هون  برد  الشتاء  علي  عبادك المستضعفين  في  كل  مكان  ,  اللهم  انزل  دفءك ورحمهك علي  كل  فقير  لا  ماوي  له	Negative
 توكلت  عليك يا  الله	Positive
 افشو  السلام  بينكم	Positive
 نهارك طيب  مبروك	Positive
 لا  يشكي  قله المال  لكنه يشكو  امانه الرجال	Positive
 سبحان  الله  مواقف  لها معني  قيمه فعلا  تعلم  ما  شاء  الله	Positive
 فعلا  احس  في  نفسي دللك	Positive
 ليش  هيك  معجبين  علي  الاردني	Negative
 كل  يوم  اجتماعات  ومناقشات  وتحليلات  ومفاوضات  بشان  سوريه  وكلو  حكي فاضي  وعلاك  مصدي  اذا  ما  في  نيه صادقه مخلصه من  كل  الاطراف  لن  تنتهي  ماساهنا	Negative
 يا  رب  قويني  علي  نفسي يا  رب  تقبل  مننا الله	Positive
 وعلي  الله  قصد  السبيل	Positive
 اللهم  لم  شمل  جميع  المسلمين	Positive
 حقيقه العمل  التطوعي  ,  يساعد  في  القضاء  علي  اوقات  الفراغ  ,  يمنحك خبرات  وتجربه  جديده	Positive
 ستجد  مساعده الله  وعونه لك عندماما تكن  النيه  صادقه	Positive
 ما  شاء  الله  علي  هلتفاءل  الي  عنده	Positive
 اذا  فكرت  مره تخسر  اصحابك يا  ليت  تخسرهم علي  احد  يستاهل  ,  صح  الحياه  تعطيك ميه  حب  بس  الحياه  ما  تهديك اصحاب  مرتين	Negative
 مش  النووي  ان  صار  وما  اظنش  اسراءيل  تسمح  باقامهه بهالسهوله  هو  اللي  بيعني  انو  نحن  متطورين  او  متقدمين	Negative
 سوبر  طقاع  اول  واحد  جايته  زبيريه	Negative
 مءامره  معروفه ضد  الشرفاء  في  هذا  البلد	Negative
 قول  يارب  ادعي  كتير  انك تكره هذه  المعصيه  وربنا كريم	Positive
 اللهم  زيد  المسلمين  وبارك  فيهم	Positive
 اطمءن  يا  قلبي فرزقي لا  ياخذه غيري	Positive
 اسوا  شعب  الله  في  الكوميديا	Negative
 الله  لا  يوفقكم محد  يخاف  علي  من  البرد	Positive
 طموح  الانسان  يدفه لتحقيق  اهدافه يا  رت  شببنا ما  يقولن  فات  الوقت  الله  يوفق  من  يشاء	Positive
 كنت  اشوف  الاجانب  اقول  موسوسين	Negative
 يا  سلام  ما  احلي  ان  يواسي  المسلم  اخاه هذه  هي  اخلاق  الاسلام	Positive
 الله  يتقبل  صلاهنا	Positive
 لا  يعني  الغبي  يدري  انه كاتب  اسمها بالورقه  مايبيلها  ذكاء  تري	Negative
 العرب  مو  بتاع  هي  الشغلات  لاكن  نحن  فاشلين  الله  معطينا كل  متطلبات  التحظر  والتطور  لاكن  نحن  لازقين  بهلتفاهات  ونضن  انو  هي  التحظر	Negative
 حلو  صديق  عمري	Positive
 راءع  ولاجمل  ?  حب  ربنا	Positive
 المغرب  بريء  منك علي  الاقل  اذا  كنت  لهجهنا صعبه فتكلم  باللغه  العربيه	Negative
 ولو  هو  انسان  وعنده احاسيس  ممكن  من  هالموقف  اللي  الكل  يشوفه يتعقد  هالانسان  من  حياهه كلها	Negative
 ماجمل  الحب  الاخوه  في  الله  ان  نخاف  علي  بعضنا حتي  في  علاقهنا مع  ربنا شء  راءع  جدا	Positive
 مش  عاجبو  الوضع  الي  هو  فيه	Negative
 الاردن  كان  افضل  حالا  بمءات  المرات  في  التعليم  و  الصحه  و  الزراعه  و  الاستثمار  .  .  .  التردي  ليس  مرتبط  بالربيع  العربي  بل  قبله بمده عام	Negative
 ان  شاء  الله  ربنا يعينا  علي  فعل  الطاعات	Positive
 بصفحات  الفيزا  علي  جواز  السفر  حاطين  صور  اثار  الاردن  عاساس  هيك  بس  اشوفهم رح  احن  و  ابطل  اسافر	Negative
 ياي  ما  ازكي  هذا  الاكل	Positive
 اللهم  اني اقسمت  عليك بك  ان  تهدي  شباب  المسلمين  وتنور  قلوبهم كما  انعمت  علي  طارق  بنعمه الاسلام	Positive
 والله  عيب  بهدلتو  حالكم	Negative
 من  رافق  وافق	Positive
 بالله  عليك فين  الاناقه  في  الناس  اللي  بتغني  دي	Negative
 اللهم  اهدنا  لكل  عمل  يقربنا اللي  حبك	Positive
 والله  شويه  عبط  الي  بيغنو  والحكام  كمان	Negative
 شعب  لا  يحركه هذا  الظلم  التعدي  علي  كرامهه هو  شعب  لا  يستحق  الحياه	Negative
 انا  انصح  كل  انسان  ان  لايكذب  لان  الكذب  مديه قصير	Positive
 لا  تياسوا  من  روح  الله  ,  الله  تعالي  لا  يعجزه شيء  ,  فكم  من  مريض  شفاه  ,  وكم  من  فقير  اغناه ,  وكم  من  مشرف  علي  الهلاك  نجاه ,  وكم  من  ضال  هديه	Positive
 اي  والله  سوبر	Negative
 البسمه  سر  من  اسرار  الحياه	Positive
 الحمدلله  وربنا يجعلنا من  المداومين  عليها والخاشعين	Positive
 وربي  عاهات  @@مستعصيه@@ه	Negative
 فاشل  فاشله برنامج  فاشل	Negative
 قصه في  غايه  الروعه	Positive
 والله  الحياه  كلها بتخزي  بدونكم	Negative
 حلواه وهي  ساكته اذا  ابتسم  كرهت  شكلها	Negative
 اللهم  باركي  فيه واهدي  كل  مسلم  لطريق  النور	Positive
 الحق  عالحقير  اللي  نزل  المنشور  بجوز  اهله لابسين  منهم ولك لاتنزل  اشي  زي  هيك  يا	Negative
 اتحزن  فان  الله  يدافع  عنك والملاءكه  تستغفر  لك و  المءمنون  يشركونك في  دعاءهم كل  صلاه  و  النبي  صلي  الله  عليه سلم  يشفع  و  القران  يعدك وعدا  حسنا  و  فوق  هذا  رحمه ارحم  الراحمين	Positive
 الحمد  لالله  علي  نعمه العقل  و  سعه  الفهم  و  نضوج  الفكر	Positive
 اذا  شعرت  بشيء  من  حالات  الاحباط  والملل  فجرب  العمل  التطوعي	Positive
 بالله  يا  شباب  وش  رايكم بالاشكال  هذه  هل  تتوقعون  اهلهم كارهينهم  والناس  تجي  لاهاليهم وتقول  لهم حرام  عليكم هذول  من  دمكم	Negative
 شكرا  لالنجمه  الراقيه  كنزه اخبار  النجوم	Positive
 ان  شاء  الله  وربنا يعيننا	Positive
 لقد  اسمعت  لو  ناديت  حيا  .  .  ولكن  لا  حياه  لمن  تنادي  ولو  نارا  نفخت  بها اضاءت  .  ولكن  انت  تنفخ  في  الرماد	Negative
 الله  عليك بجد  رنا  يهدينا كلنا ويهدي  شباب  المسلمين  جميعا  يارب  العالمين	Positive
 حكي  فاضي	Negative
 صباح  الفل  الورد  يا  شيخ  سلمان  عطر  الله  صباحك بذكره شكره حسن  عبادهه	Positive
 اللهم  انا  نعوذ  بك  من  الرياء  النفاق	Positive
 والله  لو  يجمعونهم علي  شاطء  البحر  الميت  ويخلونهم يصرخون  علي  اليهود  ولمده 30  ثانيه  ليهربون  لقبرص  عن  طريق  البحر  سباحه	Negative
 كسم  البرامج  العربيه  متخلفه بنت  شرموطه	Negative
 والله  اول  واحد  سمعهه منهم احسب  سماعتي  خربا  يا  بطني من  الضحك  والله  زاحفين	Negative
 هذا  هو  الحب  الاصيل  الوفي  بكل  معني  الوفاء	Positive
 اهلا  بك  في  دين  الحق  والسلام	Positive
 اللهم  اغفر  لي ما  لا  يعلمون  اجعلني  خيرا  منما يظنون	Positive
 جميله المعاني  المجرده  التي  تنزوي  عند  التطبيق	Positive
 نسيانك صعب  اكيد	Negative
 نحن  نحبك في  الله  ندعو  لك بظهر  الغيب	Positive
 دمك ثقيل	Negative
 يعني  لو  عايزين  يبعوه  بلغواني من  القرف  هاض  يع  يع  يع	Negative
 عيب  يغني  ده  السادات  وده ابن  مره	Negative
 اكاديمي  اللي  خلفت  عاهات  لالفن  المعاق  حاليا  فيزيدون  الطين  بله	Negative
 قول  يا  الله  ده  عنك مش  بعيد  متشلش  هم  ولا  تشعر  بضيق  اقول  يالله  اهديني  ياقلبي  عشان  اتوب  امحي  الذنوب  واهديلي  الطريق	Positive
 يعتبر  الترمس  من  المصادر  الطبيعيه  لفتح  الشهيه  وتقويه  الاجسام  الهزيله  ;  انه غني  بالكالسيوم  والفوسفور  .	Positive
 قل  لي من  تصاحب  اقول  لك من  انت	Positive
 اللهم  لا  تجعلنا من  المنافقين	Positive
 ترتيب  ونظام  منقطع  النظير  في  احدي  مدارس  الاناث  بقطاع  غزه	Positive
 مت  عليهم حيطه  هالانذال  اصحاب  الاجندات  الخاصه  الخارجيه  العميله	Negative
 قمه البلاغه	Positive
 اللهم  انر  قلوب  المسلمين  ايقظهم من  غفلههم	Positive
 الله  لا  يعطي  العافيه  ولا  الصحه  لالاخوان  المفلسين	Negative
 بس  الله  لا  يسامحكم  تلقواها بصحهكم ان  شاء  الله	Negative
 نعم  الوقت  يمر  بسرعه	Positive
 الحق  مش  علي  لجنه التحكيم  الحق  علي  الاغبيه  المشتركين	Negative
 كتير  رخيص  ومقرف	Negative
 والله  ما  في  اشي  مزعلني  الا  انه اسمه محمد	Negative
 صباح  العسل	Positive
 كلام  ذهب	Positive
 يا  مقلب  القلوب  والابصار  ثبت  قلبي علي  دينك	Positive
 جهنم  وباس  المصير	Negative
 وذلك  ليذوقوا  ايران  وسوريا  وشيعههم وبال  امرهم	Negative
 سبحان  الله  له في  خلقه شءون	Positive
 لو  سمحت  لا  تقول  اخبار  مغلوطه  ولا  ابعطيك  انفولو  جيب  رابط  الخبر  وبلاش  تصرف  من  راسك	Negative
 اصدقاء  اوفياء  ونتعلم  منهم	Positive
 مين  هاي  الي  بصوره  وءدامها  كورس	Negative
 فالاول  يصحح  مساري  الثاني  يزيد  من  اصراري	Positive
 النيه  دايما  بتكون  موجوده وربنا المعين	Positive
 بس  الحكام  ماعندهم  ذوق  لالاسف	Negative
 صحيح  الابتسامه  لها تعابير  كثيره	Positive
 بعرف  حكايات  مليانه  عاهات  مثلكم مجانين  يا  صيدات  جورج  وسوف	Negative
 مقاسك غير  مناسب  يا  شريف  مع  نفسك	Negative
 لهل  درجه في  متخلفين  في  الوطن  العربي  ?  ?  ?  ?  ?  ?	Negative
 صباحات  العقول  اليقظه  الهمم  الحييه  المتوثبه	Positive
 اللهم  حسننا حسن  اعمالنا ظاهرا  باطنا لا  تجعلنا نعمل  الالا ما  يرضيك عننا برحمهك يا  ارحم  الراحمين	Positive
 والله  انو  نذل	Negative
 اما  الغبي  اللي  يقلد  جورج  وسوف	Negative
 بارك  الله  لكما وبارك عليكما وجمع  بينكما علي  خير	Positive
 صباح  الخيرات  والعبادات	Positive
 بالله  تسكتوا  خلينا بحالنا بدناش  مشاكل  ايه	Negative
 اللهم  اتم  علينا مكارم  الاخلاق	Positive
 جزيك الله  خيرا  ياستاذ  مصطفي  علي  ماتبثه  في  انفسنا ربنا يكثر  من  امثالك	Positive
 واسال  الله  من  اثواب  رحمهه سترا  جميلا  علي  الزلات  مشتملا  وان  ييسر  لي سعيا  اكون  به مستبشرا  جذلا  لا  باسرا  وجلا	Positive
 يا  ظالم  الك يومك	Negative
 من  جد  وجد  و  من  سار  علي  الدرب  حصد	Positive
 اللهم  نسالك السلامه  من  مثل  هذه  الخيبه	Positive
 اني كومه من  القلق  والرجفه  اكثر  من  كوني  انسان	Negative
 شو  هاد  البرنامج  معقول  عرضواه علي  القنوات	Negative
 اللهم  قونا  علي  نفوسنا الضعيفه	Positive
 بدك الصراحه  بدون  زعل  جهنم  الزبانيه  من  الملاءكه  تنتظرك تموت  لتشرب  من  فروج  المومسات  صديد  اهل  النار  ان  شاء  الله  يا  اوباش  سوريا	Negative
 غبي  انتا  اشي  الصوت  هاد  بتشبهو  بجورج  وسوف	Negative
 الذي  طبعه راءع  ما  يمكن  ان  يتغير  راح  يبقه راءع	Positive
 ادعي  من  الله  ان  يقوني علي  طاعهه	Positive
 صرفات  تجعلك زوجه نكديه بجداره	Negative
 اللهم  اصلح  نفوسنا لما  يرضيك عنها	Positive
 احلي  اشي  الواحد  يوكل  بدون  ما  يطبخ	Positive
 عمرتنا كانت  مميزه جدا  وراءعه	Positive
 سالت  اصحابي ف  هذا  المجال  و  حكولي  غير  هيك  .  الموضوع  مكلف  .  الكل  باكد  انه الحل  لوضع  الاردن  الحرج  هو  طاقه نوويه	Negative
 هذا  ليس  مضحك  بل  مخزي  يا  لالخزي  العار	Negative
 الله  اكبر  شو  هيدا  اكل  الرجال	Negative
 شو  هاض  المنشور  الوسخ	Negative
 و  مفيش  احلي  من  قضاء  ربنا	Positive
 وين  الماء  كل  يوم  الميه مقطوعه	Negative
 الحمد  لالله  الذي  نصرنا نصرا  مبين	Positive
 انا  متشاءم  رح  اضل  متشاءم  حتي  ينزلوا  البنزين	Negative
 وجه  حسن  وضحكه تفتح  النفس  وعيون  خلابه	Positive
 ما  اجمل  الكلام  والاروع  ان  نطبقه	Positive
 اللهم  اجعلنا  من  يتمتعون  بروح  و  ريحان  و  جنه النعيم  من  الرحمن  صباحكم قطرات  من  ندي  الازهار	Positive
 فعلا  الطاقه  الشمسيه  هي  البديل  ليست  النوويه  لان  حتي  الدول  المتقدمه  صارت  تتخلص  من  النووي  تتجه  لالطاقه  البديله  خصوصا  نحن  الاردن  بلد  مشمس  عالطول  السنه  الكلفه  ما  اتوقع  اكثر  من  الطاقه  النوويه	Negative
 سبحان  الله  ان  الله  يرزق  الدوده  في  جوف  البحر	Positive
 اه  لو  لا  القران  لقلت  ان  انكر  الاصوات  لهذه  الاصوات	Negative
 لو  حد  يا  جماعه يعرف  طبيب  اذن  يدلني ولا  شكلي  هارميهم  خلاص  باظو	Negative
 ثكلتك  امك	Negative
 عنجد  بخزي  شو  هاد  علي  حساب  ازياء  طلع  باله	Negative
 رب  فعل  صغير  يستعظمه غيرك خاصه ان  كنت  تمثل  الاسلام	Positive
 الباقيين  سخافه سماجه	Negative
 ياخساره  العروبه  فيك	Negative
 شو  هالمنشور  الوسخ	Negative
 يلعن  ابو  التخلف  والغباء  والبياخه	Negative
 طبعا  اكيد  والف	Positive
 اقرفني  والله	Negative
 لقد  اتحفتمنا بلجواكم لجيبتنا  التي  انفجرت  بفضلكم الفاسدين  يتنعمون  باموالنا فهل  اصبح  فاسدا  لاعيش	Negative
 ولا  جورج  في  الزمنات  بس  حرام  يفضحواهم	Negative
 فشلواه مره صدق  انهم دلوخ	Negative
 كل  سنه وانتم  طيبين	Positive
 اللهم  اجعلني  خيرا  منما يظنون  اغفر  لي ما  لا  يعلمون	Positive
 مش  باين  منيح  ليش  عم  تكذبو	Negative
 ناس  مطفره  من  الاخر	Negative
 ما  في  داعي  لمصايب  جديده لالبشر  ولالبيءه	Negative
 فعلا  زي  ما  حكي  اخر  شي  مهزله  وانا  مهزله  اللي  ضيعت  وقتي  اشوف  هيك  مسخره فعلا  اني مسخره	Negative
 بالمناسبه  انا  مءدب  جدا  ,  لا  احتسي  الكحول  ولا  ابحث  عن  علاقات  مشبوه	Positive
 اخبار  مسخره	Negative
 حسبي الله  عليكم الله  بحاسبكم علي  كل  حد  بينفتن  بسلبكم الله  لا  يسامحكم	Negative
 حسيت  كله تمثيل  وسخافه غباء	Negative
 فوق  من  اللي  انت  فيه ربك دايما  جمبك  لو  ناديتو  هتلاقيه  جايز  ده  اختبار  ركز  فالاجابه  وقول  يارب  وخد  قرار	Positive
 يعني  يجبون  كم  واحد  يعطونهم فلوس  ويجون  يستهبلوا  عندهم عشان  يحركون  البرنامج	Negative
 تبارك  الرحمن  اللهم  زد  فينا وبارك لنا يارحم  الرحمين	Positive
 اللهم  اغننا بحلالك عن  حرامك اغننا بفضلك عمنمن سويك	Positive
 جزيك الله  كل  خير  بسمه امل  راءعه وشيقه جد	Positive
 اللهم  لا  تحرم  احد  من  هذه  النعمه	Positive
 بعد  عقود  مرض  الكلب  واستبشرنا نحن  الشعب  اخيرا  مات  الكلب  واصبح  ابن  الكلب  رءيسا  بالاجماع	Negative
 دمرني النصاني  هودعيك  يربي  بطني	Negative
 الزعل  بدايه الطريق  لالامراض	Negative
 الله  يرحمنا برحمهه	Positive
 فشرت  عين  الشيعه  والله  بنحرقهم  حر	Negative
 صباحك ورد  ياسمين  معطرين  بنسمات  من  الجنه  يا  شيخنا الجليل  حفظك الله  من  كل  سوء  نحبك في  الله	Positive
 الله  اكبر  والعزه  لالسلام	Positive
 صباح  النور  السرور  الورد  المنثور	Positive
 يا  غبي  كوادر  الاخوان  المسلمين  في  كل  بقعه من  هالارض	Negative
 عوام  الشيعه  بين  ساذج  ومغفل  وجاهل  ومتجاهل  ولا  يمكن  لعاقل  ان  يظن  ان  عباده الله  تكون  ببان  تقضي  حياهك بين  لطم  ولعن  وتباكي	Negative
 يارب  توب  علينا وساعدنا نتوب  وبصرنا بعيوبنا لان  ساعات  كتير  بننسه	Positive
 ما  في  احلي  من  التفاءل  الواحد  بعيش  مرتاح	Positive
 ارحمونا  من  الجوكر	Negative
 الحل  الوحيد  حب  الله  ورسوله وطاعههم	Positive
 كلهم معندهمش  احساس	Negative
 اللهم  ارضنا و  ارضي  علينا	Positive
 اخر  واحد  مهستر	Negative
 حلو  .  .  .  نفس  العرطه  سمعناها قبل  4  سنين  .  .  .  طيب  تصرف  وسوبديلك  اشي  يرفع  اقتصاد  البلد	Negative
 نفسي اروح  عمره واشوف  الكعبه	Positive
 نرجو  من  الله  ان  يتقبل  صلاتنا رغم  ما  تمر  به بلدنا من  ازمه صار  الواحد  خايف  علي  نفسه مستعجل  بصلاته انا  كلما  صليت  اعتبرها صلاه  مودع  فيخشع  قلبي تدمع  عيناي	Positive
 لي جماعه الاخوان  الخسيسه  كيف  بدكو  الوطن  يتصلح  وانتو  قسمتوه  لفريقيين  كل  واحد  منكم اخدنا  لمطرح  ومش  عارفين  واصليين  لوين	Negative
 رءيس  مو  عارف  يحكي  حرف  الاس  روح  تخيب  ولك يلعنها انيسه علي  هيك  جحش  خلفتو	Negative
 هاي  اخلاق  خليلنا الحبيب	Positive
 ومن  احسن  قولاممن  دعالي  وعمل  صالحاووقال  اني من  المسلمين	Positive
 الله  يلعن  امك وش  ها  القرف	Negative
 تماما  اللهم  لا  تحرمنا  الصدق  في  الكلام	Positive
 ملاحظه الكبسه  ما  بتكهرب  والله	Negative
 شاهد  تحرش  جماعي  بسيده تحمل  طفلها علي  كورنيش	Negative
 اما  وهابيهك فحدث  ولا  حرج  الناس  يقادون  الي  المساجد  غصبا  ويجلدون  كالابقار  ان  هم  ابوا	Negative
 القلب  الذي  يءمن  بالله  لا  يياس  ابدا  انه يسير  نحو  النور  وا  لا  مل  .  .  والحياه  .  .	Positive
 وزير  التعليم  العالي  :  لا  زياده  لالدعم  المالي  لالجامعات  خلال  السنوات  الثلاث  المقبله	Negative
 الله  يرزقها كل  مشتهي  يا  رب	Positive
 مات  في  القريه  قردا  فاسترحنا  من  اذيه خلف  الملعون  عجوزا  فاق  في  الخرف  اباه	Negative
 اكيد  لا  في  عندك ناس  بتفهم  ووفي  ناس  عند  الاجانب  ما  بتفهم	Negative
 لا  تخسر  قيمهك بكلمه ,  ولا  تفقد  احترامك بزله ,  ولا  تجعل  همك في  الدنيا  هو  حب  الناس  لك ,  فالناس  قلوبهم متقلبه قد  تحبك  اليوم  و  تكرهك غدا	Positive
 الله  يلعن  الي  علمكم التطور  يا  متخلفين  يا  رجعيين	Negative
 صباحك مبروك  عدوك مهلواك	Positive
 اللهم  ارزقنا  الصدق  في  طلب  الاخلاص  والاخلاص  في  طلب  الصدق  واجمع  لنا بينهما بعفوك وقدرهك يا  الله	Positive
 كثر  الكلام  في  هذان  الموضوعين  ولم  يتحقق  علي  الواقع  شي  اصبح  المواطن  يتبع  سراب	Negative
 ونشوف  اغلي  الاحبه  في  الروضه  الرحيبه	Positive
 اصواتهم مع  التوتر  خربت	Negative
 زهايمر  وخرف  وحبتين  كبتاجون	Negative
 الله  الله  الله  يحفظك يا  مملكه الانسانيه  لم  تقتصر  مساعده السوريين  في  الاردن  علي  المعونات  الغذاييه  او  الطبيه  بل  حتي  شنط  مدارس  الاطفال  بكل  شي	Positive
 بيه  الزناخه	Negative
 تضرب  منك لعدوله	Negative
 اللهم  قو  ايماننا لنكون  اصحاب  عزيمه  قرار	Positive
 انا  بحب  كل  الناس  بتمنالهم  الخير	Positive
 مثل  الاميره  من  حواليها حرس  تمشي  دلع  و  من  الترف  @@متعاليه@@ه ما  كل  خيال  يروض  له فرس  مهره اصيله من  حلاها غاليه	Positive
 صباح  @@ملءه@@ه الخيرات  المسرات	Positive
 نسال  الله  تعالي  ان  تكون  بحق  ارحنا  بها يا  بلال  ليس  ارحنا  منه	Positive
 و  نرجو  لك دوام  الخير  المحبه  من  الله  من  الناس	Positive
 لما  اجد  فيها الالا الجراح	Negative
 الابتسامه  كلمه طيبه بدون  حروف	Positive
 وهذه  من  اكبر  المشاكل  التي  تءرق  الشباب  في  هذه  الايام	Positive
 مابتحكي  معه هيك  انزلع  لاعاد  اشووفك  جلطتني	Negative
 نعم  الاخ  و  الصديق  اخلاقك تدرس	Positive
 ما  في  احلي  من  الفرح	Positive
 اللمه  هي  احلي  اشي  بالافراح	Positive
 كانت  العرب  في  الجاهليه  ,  يصيبها التشاءم  ان  رات  رجل  او  امراه لون  عينيه ازرق  وكانت  تعتقد  انهم شياطين  او  مس  شيطاني  اصابهم وهم  اجنه	Negative
 يارب  اهدي  بنات  وشباب  المسلمين  الي  ما  يرضيك عنهم وكفيهم شر  فتن  الدنيا  والاخره	Positive
 ما  في  احلي  من  انه الواحد  يوكل  وينام	Positive
 كرامهي اولي	Positive
 الحمد  لالله  كلما  اري  ناس  اسلموا  تعم  الفرحه  في  قلبي	Positive
 صباح  الدرب  للجنه و  بلبل  شادي  بفنه و  ريحه الياس  و  الحنه	Positive
 صباحكم تفاءل	Positive
 ربنا  يكفينا هذا  الشر	Positive
 انا  بكرهك	Negative
 كباب  كباب  واخرهها لحم  كلاب  تكرمون  ,  احذروا	Negative
 صدقت  الله  يا  شيخ	Positive
 من  اسرار  النجاح  المتواصل  والثبات  علي  القمه  :  العمل  الدءوب  والانضباط  بالمواعيد  والاعمال  والتفكير  الايجابي	Positive
 الله  اكبر  ما  احلاكم وما  اشجعكم	Positive
 البقاء  في  الخيال  دمار	Negative
 اللهم  يا  مجيب  من  دعاك اعنا  علي  تقويك بتقويك وارزقنا  حسن  طاعتك وتمام  رضاك واغفرلنا  ولوالدينا ولكل  من  له حق  علينا	Positive
 سوريا  تعرضت  لمءامره  والامر  المحزن  ان  ولاد  سوريا  انزلقو  فالمءامره  هاذي  والشنيعه	Negative
 الله  لا  يخلف  عليهم لا  يكثر  خيرهم فعلن  شعب  مسكين  عبد  الله  النسور  بطل  رفع  الاسعار	Negative
 يلعن  اخت  المياعه  والبياخه	Negative
 بتقول  كلام  زي  الفل	Positive
 انا  لا  احلم  ان  اغير  العالم  ولكن  احلم  بان  استطيع  ان  ارسم  البسمه  علي  وجوه  الاخرين	Positive
 يالا  من  هون  كس  امك انت  و  هو  ,  بلاش  قرف  و  وساخه	Negative
 كلام  بليغ  اللهم  ارزقنا  الزوج  الصالح  من  يعرف  معني  رفقا  بالقوارير	Positive
 عني كل  يعلقو  الا  انا	Negative
 كيد  النساء  لولا  مكر  الرجال  لما  خلقت  حواء  بكيد  عظيم	Negative
 متي  رح  نشوف  صحفيين  يكشفوا  فضاءح  الفساد  وما  يخافوا  من  اي  جهه	Negative
 وقف  قلبو  لحسن  الشافعي	Negative
 افعال  لا  تضاهيها اقوال	Positive
 اضحك  تضحكلك  الدني	Positive
 ان  الله  لا  يتخل  عن  عباده ابدا	Positive
 نحن  ما  بدنا  اياه اننا ما  منفهم  المفاعل  النووي  فوق  طاقهنا صعب  علينا بكره بذكركم سالوا  الباص  السريع  الثقه  معدومه القمح  فاسد  المصفاه  مش  حسب  المواصفات  الخضار  الفواكه  مواد  كيماويه شوارع  مش  مصانه  حفر  مطبات  الخ  الافضل  استغلال  الطاقه  الشمسيه  او  الريح  او  الماء  ليس  هروب  من  التطور  انماما الابتعاد  عن  الفشل  الاكيد  عبر  التجارب	Negative
 صباحك خير  يا  دكتور  سلمان	Positive
 اوغاد  باعو  البلد	Negative
 كنا  نقول  البلد  حاميها حراميها ماذا  سنقول  الان  مفتياها حراميها الله  الواحد  تحير  في  هذه  الامه  التي  اصبح  الحليم  فيها حيران	Negative
 حسبي الله  نعم  الوكيل  في  كل  ظالم  مفتري  الله  يعين  الشعب	Negative
 اغرورقت  عيناي بالدموع	Negative
 مقرف  جدا  هذا  الشخص	Negative
 المشاركين  بينو  لالناس  انه اللي  قايمين  علي  البرنامج  حمير	Negative
 دي  اخلاق  السلف  الصالح	Positive
 بني  البرنامج  النووي  الاردني  علي  عده تصورات  خاطءه بشكل  خطير  تتعلق  بالتكنولوجيا	Negative
 الشو  اسمو  ستار  اكاديمي  ولا  المسخره  عل  العالم  اكاديمي	Negative
 دعواه اخاك بظهر  الغيب  لا  ترد	Positive
 ياريت  حدا  عم  يواسي  السوريين  بغربههن لالاسف  باب  رزق  جديد  لالعرب	Positive
 هاد  برنامج  وسوبر  ستار  بنامج  شوف  البريطان  شو  بعملو  فعلن  سوبر  الهبل	Negative
 سبحان  الله  اللهم  ارزقنا  الطمانينه  اليقين	Positive
 كلامك جميل  وراءع	Positive
 صباح  السعاده  العامره	Positive
 الله  يهدي  التاءهين  والضالين  الي  طريقه	Positive
 في  ناس  كتير  ربنا كرمهم بنعمه الاسلام  ولكنها لا  تدرك  قيمهها	Positive
 هذول  مساجين  ولا  ايش	Negative
 اللهم  ارنا الحق  حقا  ارزقنا  اتباعه ارنا الباطل  باطلا  ارزقنا  اجتنابه	Positive
 مقال  راءع  والله  يهدي  البنات  يارب  ويرجعهم لالصواب	Positive
 شيء  مءسف  الله  يهديه	Negative
 حركه ارحمينا  الله  يشيلك اقول  كيف  اخوكي  وابوكي  راضيين  عنك اف  عندك ايزي	Negative
 ولك واحد  كندره	Negative
 الفاشل  من  يياس  ويقف  عند  اول  حاله رسوب	Negative
 اللهم  تب  علينا انك التواب  الرحيم	Positive
 تذكر  من  كذب  يكتب  عندا  الله  كاذب  لا  اله  الا  الله  اما  من  يتحري  الصدق  يكتب  عندا  الله  صادقا	Positive
 عاهاتك يا  وطنعاهاتك  يا  وطن	Negative
 راءعين  يا  مصريين	Positive
 انا  توجيهي  سعودي  و  بدرس  بجامعه من  احسن  جامعات  الاردن  ,  و  الشعب  قاعد  يعيد  توجيهي  و  يرسب  من  وري  الوزير	Negative
 يجب  علي  الحكومه  العوده  بالتوقيت  الي  الساعه  الثالثه	Negative
 تدرون  يا  جماعه الخير  انها بتتعدب  والله	Negative
 والله  حرام  والله  موتواه لشعب  الاردني  من  وين  بدنا  نجيب  الكو  من  وين  يا  الله  ارحمو  من  في  الارض  يرحمكم من  في  السماء  الله  حرام	Negative
 الاسف  مافي  اي  حدا  بتحمل  الانتقاد	Negative
 شنو  السالفه  يعني  اتقارنون  القران  الكريم  ويه  نجوه  كرم  هاي  العرمه  لا  الله  الا  الله	Negative
 عيب  والله  اسم  المقطع	Negative
 من  يتوكل  علي  الله  فهو  حسبه	Positive
 ياجماعه  يقولون  بشار  الاسد  مات	Negative
 مسخره والله	Negative
 الخشوع  احساس  جميل  جد  امام  الله  القلب  يحب  الدمع  صافي  متعه بعد  الصلاه  راحه فاءقه اتمني  لكل  المسلمين  هذا  الخشوع	Positive
" ""  عندماما يقول  لك احد  :  ابشرك فانك مباشره تفرح  وتبتسم  فكيف  اذا  كان  القاءل  هو  الله  سبحانه وتعالي  حين  يقول  :  ""  ""  وبشر  الصابرين  ""  ""  """	Positive
 وربي  كلبهي جات  جلست  عندي اول  ما  فتحت  هالفيديو  ويوم  خلص  التفت  لها الا  والاقيها نايمه	Negative
 صباح  الاماني  الجميله  المحققه  باذن  الله	Positive
 سخافات  وتخلف  شباب  وصبايا  هل  الايام	Negative
 انا  كل  يوم  اقول  غدا  سوف  اصلي  لكن  لا  اقدر  انا  ادعوا  الله  داءما  ان  يهديني ارجو  من  من  يملك  حل  مراسلتي	Positive
 الله  يوخذكم	Negative
 اللهم  ارزق  ابناء  المسلمين  زوجات  صالحات  وبنات  المسلمين  ازواج  صالحين	Positive
 يلعن  الساعه  الي  بشرت  فيك	Negative
 سبحان  الله  خالق  السماوات  الارض	Positive
 بتمني  لو  ان  تقوم  بعثه لالدعاه  من  مصر  تزور  جميع  البلاد  تعرفهم تشرح  ما  هو  الدين  الاسلامي  تنشر  بحق  في  كل  مكان	Positive
 اه  يا  ابو  القمل	Negative
 اكيد  حياهي ما  في  حدا  بشبهك لو  في  كان  نتحرت  زمان	Negative
 ربنا  يتوب  علينا من  المعاصي	Positive
 اسوء  شيء  ان  تكذب  انك ستبدان  سلسله لا  نهايه  لها من  الاكاذيب  في  النهايه  ستكشف	Positive
 ما  ازنخ  منك الي  هاي  اللينكات  اللي  بتسم  البدن  بتتعب  يعني  لما  توخد  الصوره  وتنزلها تنزيل  عادي	Negative
 انا  اخدت  قرار  وبعدت  عن  معصيه  لالله  وقدرت  وربي  وفقني	Positive
 استعينوا  بالله  يا  مسلمين	Positive
 احمد  الله  تعالي  ان  اولادي لايدرسون  في  مدارس  الاردن  .	Negative
 منكو  لالله  نحن  لاقيين  حق  الخبز  لحتي  ترفعو  البنزين  صار  الواحد  يحب  يخلص  دراسه عشان  ما  يضل  بلاردن  لانو  ما  فيها اشي  لا  رواتب  لا  اشي  جد  بلد  مش  فقير  بس  كلو  بوكل  كلوالله  ما  بنلوم  الحراميه  هيك  بلد	Negative
 فاقد  لكل  معاني  الاحساس	Negative
 خفي  علينا يا  حجه بلا  مانسمع  صوهك الناعم  ويصيبنا صرع	Negative
 وش  التخلف  هذا	Negative
 اي  الله  صحيح  اهم  شي  الانسان  كرامهه	Positive
 للهم  املا  قلبي بحبك وحب  نبيك وحب  كل  عمل  يقربني الي  حبك	Positive
 بسمه امل  حلوه	Positive
 حرام  عليك كانو  بقره بتولد	Negative
 لو  كاكا  بالبرازيل  كنت  اعطيط  لايك  بس  هيك  فشر	Negative
 كلهم فاجرين	Negative
 جميل  جدا	Positive
 بعدك ما  شفت  اشي	Negative
 حثاله  شباب  صايع	Negative
 كل  الاحترام	Positive
 الله  عليك يا  شيخ  تحفه	Positive
 و  يرزقكم من  حيث  لا  تعلمون	Positive
 مش  عارف  ليه  بيتحوله  هما  الي  دواره عليك وكان  نفسهم تكون  معيهم في  الاول	Positive
 يارب  كرهني وابعدني فيما  يغضبك	Positive
 ملحمه  بالجامعه  الاردنيه	Negative
 برلمان  المانيا  يقر  باغلبيه كبيره التخلي  عن  الطاقه  النوويه  حتي  2022  الاردن  يطرح  عطاءلانشاء  محطه طاقه نوويه  الله  لا  يطعمنا الحج  والناس  مروحه	Negative
 صراع  متصاعد  لالهيمنه  علي  سوق  الالمنيوم  العالميه	Negative
 اللهم  اهدني  الي  ما  تحب  ترضي	Positive
 المواساه  والمحبه  بكل  الامور  رمز  الاخوه	Positive
 ومن  خسء  الشيعه  اخوان  القرده  الخنازير	Negative
 الله  لا  يحرم  حدا  من  العاءله  الدافيه  والذريه  الصالحه	Positive
 استهبال  باستهبال	Negative
 شخصيه تافه	Negative
 الله  ياريت  يبقي  في  اخلاق  كده في  الوقت  ده	Positive
 عندك حق  انت  امل  جميل  مشرق	Positive
 بدكو  تخلوانا نشحد	Negative
 صدقت  يا  استاذ  عمر	Positive
 تعليم  الاطفال  علي  الاغاني  وعلي  الرقص  بدل  من  تعليم  القران  الكريم  بدل  من  تعليم  الدين  الله  لا  يوفقكم	Negative
 اتقوا  الله  فينا بكفي رفع  اسعار  الرواتب  بالحضيض	Negative
 فاشلين  الي  ما  لا  نهايه	Negative
 واحد  هامل	Negative
 صباحك جمال  روعه	Positive
 حزني كثير  والله	Negative
 المهم  هو  الصادق  معي  الناصح  لي	Positive
 عمل  السريره  هو  العمل  الخالص  لالله  اللهم  ارزقنا  عمل  السريره	Positive
 اللهم  انا  نسالك رزقا  حلال  طيبا  مباركا  يعيننا علي  طاعهك	Positive
 الله  يلعنك	Negative
 ربنا  يبارك  فيه يكون  قدوه لالجميع  المسلمين  في  انحاء  العالم	Positive
 يع  بتقرف  انت  وسخ  يع  شوهاي  الوساخه	Negative
 لالله  يحرق  قلبك يبشار	Negative
 السلام  عليكم الحقيقه  انا  لا  اعرف  شو  وقاحه هاي  اللجنه  المشترك  يعطي  ما  عنده من  مواهب  هذا  ما  عنده وهم  يعطون  ما  عندهمما	Negative
 فاظفر  بذات  الدين  تربت  يداك	Positive
 اللهم  رزقنا مكارم  الاخلاق	Positive
 ربنا  المستعان  ادعولنا  ارجوكم	Positive
 هاي  نتيجه  انه ينحط  انسان  في  موقع  مسءوليه	Negative
 هذا  الشخص  هو  انت  يامصطفي	Positive
 كنا  نقول  عاهات	Negative
 الظاهر  عقلك تافه  من  اصحاب  العقول  المقفله	Negative
 يارب  دعوناك فستجب  لنا وحقق  لنا ماهو  اصلح  وافضل  لنا	Positive
 الحمد  الله  علي  الاسلام  يا  رب  اهدي  كل  من  احب  هذا  الدين  وكل  من  تردد  في  دخوله وارحمنا  جميعا	Positive
 حلو  الشخص  يكون  عنده هدف  يشتغل  عليه لكن  الدراسه  شء  ضروري	Positive
 ربي  ينعم  علينا بنعمه الخشوع	Positive
 لا  حول  ولا  قوه  الا  بالله  ليش  الحرج  هدا	Negative
 شو  هالافكار  الجهنميه	Negative
 عد  دراسه قمنا  بها تبين  ان  وضع  خلايه  شمسيه  في  صجراء  الاردن  والسعوده  تكفي  لالاناره  الارض  كامله مدي  الحياه	Positive
 ولا  شكل  ولا  صوت  منين  جايبينهم  هالكاءنات  الغريبه  اه  يا  بطني بس	Negative
 الله  يبارك  لنا في  ايامنا	Positive
 الي  جهنم  وبءس  المصير	Negative
 الفلاكا  تجعل  من  يتناولها يعتقد  انه زومبي  واكل  لحوم  البشر  ويبدا  بالبحث  عن  دم  ليشربه وظهرت  في  التسعينات  في  امريكيا  ثم  اختفت	Negative
 جابو  المسخره  لنفسهم الله  لايردهم	Negative
 هو  في  حد  اساسا  لسه  بيتابع  البت  دي  هاي  عنجد  بتقرف	Negative
 انا  ما  اغيب  الا  اذا  كرهت  اني ابقي  راجع  افعالك قبل  كل  حاجه	Negative
 غرباء  نحن  حتي  في  احلامنا نعيش  واقع  ليس  لنا فيه نصيب  .  .  ?  نتمني  اشياء  كثيره لكن  بدون  ان  نتحمل  اي  مسءوليه .  .  .  .  .  ننظر  الي  انفسنا فقط	Negative
 فعلا  الله  يجزيك كل  الخير  دكتور  والله  يثبتنا علي  ديننا	Positive
 بارد  ومصقع	Negative
 يخرب  بيتك ما  ازنخك	Negative
 تحطم  ماتبقي  من  اطيافي	Negative
 خلق  الايثار	Positive
 يلعن  ام  السخافه	Negative
 دعاء  جميل  ماشاء  الله	Positive
 فتاه تحاول  استعراض  جسدها	Negative
 انا  دمرت  انا  دمرت  مستقبلي  ضاع  وما  معي  اكل  خبز  شو  هالحياه  شو  هالقرف  مش  حياه الحياه  كلها ظلم  ما  في  شغل  الاردن	Negative
 والشكرلله  والفضل  لالله  علي  هذه  النعمه  التي  انعم  الله  علينا بها وجعلنا من  الماء  كل  شي  حي	Positive
 بتخافي  حد  ياخد  مكانك مع  انك مالكيش  مكان  اصلا	Negative
 ما  اروعهم	Positive
 يا  الله  استجب  دعاءي  يالله  مادكيت  بابك يوم  ورحعتني  خاليه الوفاض	Positive
 لا  استطيع  اللهم  ارزقنا  العافيه  وشكر  نعمهك	Positive
 الله  يحمي  البلد  من  كل  مخرب  والله  يعطيكي  العافيه  رجال  الامن  العين  السهره  علي  حمايه  البلد  من  اصحاب  النفس  المريضه  انتم  النشامي	Positive
 اصلا  كتير  من  البنات  بدهن يحكن مع  الشباب	Negative
 عشان  هيك  قال  النبي  صلي  الله  عليه وسلم  ان  الكذب  يهدي  الي  الفجور  والفجور  يهدي  الي  النار	Positive
